episode,reward,length,epsilon,mean_loss,steps
1,-111.6142443237291,94,0.995,7.914439725875854,94
2,-250.043776673194,110,0.990025,67.96045524716378,204
3,-215.45639320287142,108,0.985074875,77.76082977056504,312
4,-324.0060214070826,93,0.9801495006250001,84.8990836596489,405
5,-135.95463574153342,99,0.9752487531218751,57.19154401183128,504
6,-345.5570601295906,80,0.9703725093562657,77.56978958129883,584
7,-292.82995290768326,98,0.9655206468094844,71.6413968360424,682
8,-81.8407493676681,85,0.960693043575437,67.31916040897369,767
9,-113.43957290302369,110,0.9558895783575597,42.831010155677795,877
10,-244.16028130191572,94,0.9511101304657719,38.53284998893738,971
11,-372.6280584902223,98,0.946354579813443,31.359394966363908,1069
12,-153.32621385559383,131,0.9416228069143757,18.71322563648224,1200
13,-425.7409255037268,110,0.9369146928798039,26.478488812446596,1310
14,-130.99650832662581,124,0.9322301194154049,24.281826779842376,1434
15,-92.08763239029788,105,0.9275689688183278,27.712745974063875,1539
16,-175.146147015182,71,0.9229311239742362,23.73939683318138,1610
17,-435.2894300194087,118,0.918316468354365,28.24352272748947,1728
18,-48.60792147759102,137,0.9137248860125932,30.26409077644348,1865
19,-163.48285173873018,69,0.9091562615825302,33.324344830513,1934
20,-147.5486016592471,77,0.9046104802746175,29.167598567008973,2011
21,-265.90544711132446,125,0.9000874278732445,29.557710900306702,2136
22,-146.96493250418422,117,0.8955869907338783,22.077496435642242,2253
23,-244.23734413392452,102,0.8911090557802088,27.058711562156677,2355
24,-72.34583026284025,75,0.8866535105013078,26.194785093069076,2430
25,-145.2289169856279,119,0.8822202429488013,19.92613993406296,2549
26,-164.1517309134282,104,0.8778091417340573,25.37837657570839,2653
27,-121.44041550081963,73,0.8734200960253871,23.425846260786056,2726
28,-178.16940197653668,98,0.8690529955452602,26.21528776526451,2824
29,-49.32008849389922,107,0.8647077305675338,28.470868892669678,2931
30,-121.52240174301758,90,0.8603841919146962,21.828211745023726,3021
31,-194.242869375146,134,0.8560822709551227,32.84291285514831,3155
32,-115.77371342595475,81,0.851801859600347,32.71391394138336,3236
33,-193.4176625899545,93,0.8475428503023453,36.49731220841408,3329
34,-157.4840907328276,109,0.8433051360508336,29.16320139288902,3438
35,-66.90074951469975,78,0.8390886103705794,28.335924520492554,3516
36,-139.2941249618925,81,0.8348931673187264,25.41583806872368,3597
37,-107.79914302047995,85,0.8307187014821328,27.11454257965088,3682
38,-79.89533858369285,121,0.8265651079747222,21.17743284344673,3803
39,-55.109543765977804,116,0.8224322824348486,23.429370087385177,3919
40,-84.4479401748109,103,0.8183201210226743,17.267535222768785,4022
41,-110.62552450672385,81,0.8142285204175609,19.760943709611894,4103
42,-62.06740648711523,128,0.810157377815473,23.90167454957962,4231
43,-84.1372129456274,89,0.8061065909263957,19.10540673971176,4320
44,-116.67527167661156,106,0.8020760579717637,19.751519453525543,4426
45,-139.52146807240268,94,0.798065677681905,23.08741706609726,4520
46,-222.46345233229553,148,0.7940753492934954,16.27945883393288,4668
47,-45.20724989747145,67,0.7901049725470279,17.050607854127882,4735
48,-74.81815733235752,104,0.7861544476842928,25.60691267490387,4839
49,-91.86676972956549,70,0.7822236754458713,22.475415127277373,4909
50,-42.28620596384346,118,0.778312557068642,11.575155379772186,5027
51,-74.17672107282115,96,0.7744209942832988,18.341638942956923,5123
52,-193.45963175217753,108,0.7705488893118823,25.44093796491623,5231
53,-196.29688544954303,99,0.7666961448653229,21.397081631422044,5330
54,-52.0562036400579,115,0.7628626641409962,19.56829024553299,5445
55,-66.47695339982397,101,0.7590483508202912,18.347564774751664,5546
56,-94.10240692324543,110,0.7552531090661897,14.911531585454942,5656
57,-76.55615130474067,91,0.7514768435208588,18.58665288090706,5747
58,-73.65763610332849,73,0.7477194593032545,16.642423491477967,5820
59,-22.702702756502774,117,0.7439808620067382,13.774687081575394,5937
60,-88.58620999666051,115,0.7402609576967045,15.890342231988907,6052
61,-82.00027929561077,122,0.736559652908221,18.452632031440736,6174
62,-100.46743634757651,112,0.7328768546436799,16.296892113685608,6286
63,-89.92761386238529,77,0.7292124703704616,9.664818460941314,6363
64,-211.33542414503597,117,0.7255664080186093,14.314298081398011,6480
65,-41.528650546850116,74,0.7219385759785162,20.51749986052513,6554
66,-93.85728535484446,76,0.7183288830986236,14.723438754081727,6630
67,-81.47010833592581,129,0.7147372386831305,17.148500252962112,6759
68,-79.59401525407362,128,0.7111635524897149,15.649121189117432,6887
69,-76.45931251793942,95,0.7076077347272662,12.455902725458145,6982
70,-121.16544872349695,104,0.7040696960536299,13.532948743104935,7086
71,-58.86212796558454,101,0.7005493475733617,11.303991959095,7187
72,-111.30515917718522,103,0.697046600835495,17.461075752973557,7290
73,-177.93404212276818,138,0.6935613678313175,17.15790365934372,7428
74,-35.90370858616244,112,0.6900935609921609,16.31833738207817,7540
75,-70.72263124700531,102,0.6866430931872001,17.150981813669205,7642
76,-39.07119259453428,114,0.6832098777212641,14.341319878101348,7756
77,-91.82455759430675,107,0.6797938283326578,16.5784096968174,7863
78,-64.88515066201504,103,0.6763948591909945,12.417749367952347,7966
79,-39.503026446063814,82,0.6730128848950395,17.652653299570083,8048
80,-83.41720877954646,117,0.6696478204705644,19.023574967384338,8165
81,-76.23146310601385,99,0.6662995813682115,14.200632611513138,8264
82,-35.66572195834344,189,0.6629680834613705,18.952096469402314,8453
83,-73.05702367056921,91,0.6596532430440636,17.53770927786827,8544
84,-65.63800096026277,102,0.6563549768288433,11.709845380783081,8646
85,-52.867025593881124,133,0.653073201944699,19.126499485969543,8779
86,-42.93429865193616,110,0.6498078359349755,12.080463740825653,8889
87,-78.24341127885862,110,0.6465587967553006,13.84809900045395,8999
88,-35.303509684186835,108,0.6433260027715241,11.52614231109619,9107
89,-65.59389826483414,130,0.6401093727576664,14.16992757320404,9237
90,-55.18077957724623,118,0.6369088258938781,17.18519913315773,9355
91,-18.988190653728807,153,0.6337242817644086,17.07058881521225,9508
92,-60.78238311570293,149,0.6305556603555866,17.28562688589096,9657
93,-26.734575697854325,97,0.6274028820538087,10.908134132623672,9754
94,-74.30217728804804,97,0.6242658676435396,15.981872171163559,9851
95,-73.95548530532733,113,0.6211445383053219,8.325508781671523,9964
96,-51.35447424351331,103,0.6180388156137953,16.188149369955063,10067
97,-89.32448757043879,92,0.6149486215357263,18.06746526956558,10159
98,-81.10777366959952,128,0.6118738784280476,12.064978278875351,10287
99,-6.8901860573423335,108,0.6088145090359074,14.148636161088943,10395
100,-78.49451568320535,161,0.6057704364907278,15.868140785694122,10556
101,-57.29558862474167,134,0.6027415843082742,11.715846335887909,10690
102,-50.09528220434534,118,0.5997278763867329,11.97486731648445,10808
103,-56.44682058113426,124,0.5967292370047992,11.172461462020873,10932
104,-110.081243096619,89,0.5937455908197752,11.003629370927811,11021
105,-42.78735005625551,88,0.5907768628656763,11.100643903017044,11109
106,-40.913279187626976,181,0.5878229785513479,17.62373944044113,11290
107,6.572080409334248,79,0.5848838636585911,17.148074185848238,11369
108,-65.83574003861004,86,0.5819594443402982,21.464890596866606,11455
109,-409.46233953025796,169,0.5790496471185967,13.572558759450912,11624
110,-90.3154918219776,127,0.5761543988830038,17.485377849340438,11751
111,-211.02963548689678,198,0.5732736268885887,16.79306022644043,11949
112,-37.28413041427953,148,0.5704072587541458,16.77987274169922,12097
113,-266.9246784262411,161,0.567555222460375,19.15490161895752,12258
114,-198.91757549444338,223,0.5647174463480732,14.789390479326249,12481
115,-74.46867839200883,96,0.5618938591163328,20.54239010334015,12577
116,26.116996518786735,161,0.5590843898207511,16.06127330183983,12738
117,-57.77183930585851,127,0.5562889678716474,19.603092234134674,12865
118,-10.63071722407625,115,0.5535075230322891,23.953186507225038,12980
119,-115.82788911906201,110,0.5507399854171277,18.27004068136215,13090
120,-6.177255553312548,120,0.547986285490042,19.77027043223381,13210
121,-170.8694031859996,142,0.5452463540625918,16.562641584873198,13352
122,-13.666840192490582,99,0.5425201222922789,16.055791043043136,13451
123,7.171541264809861,98,0.5398075216808175,12.988440269231797,13549
124,-124.98649412032005,85,0.5371084840724134,17.189919548034666,13634
125,-33.712149184613196,171,0.5344229416520513,17.6880710542202,13805
126,-40.08419004336775,153,0.531750826943791,13.429676545858383,13958
127,-58.26961551099761,118,0.5290920728090721,12.030952326059342,14076
128,-57.30673463372561,103,0.5264466124450268,10.22422452569008,14179
129,-24.912876166049983,164,0.5238143793828016,12.417235088348388,14343
130,-70.9493401876179,146,0.5211953074858876,13.194445749521256,14489
131,-87.4269724820304,134,0.5185893309484582,15.754780846834183,14623
132,-23.20089767820481,212,0.5159963842937159,12.225835956335068,14835
133,-181.86191285994215,148,0.5134164023722473,15.451605191230774,14983
134,-6.5549390448569795,214,0.510849320360386,13.60945811510086,15197
135,9.536937814099161,115,0.5082950737585841,17.033633671998977,15312
136,-68.05004802361456,156,0.5057535983897912,13.830989515781402,15468
137,-40.221394926189305,173,0.5032248303978422,15.943044245243073,15641
138,-48.91664386954477,151,0.500708706245853,14.470258265733719,15792
139,-18.43397871598833,128,0.4982051627146237,14.98567073583603,15920
140,-75.557290261243,133,0.49571413690105054,16.850966496467592,16053
141,-32.55231548785366,121,0.4932355662165453,16.8179856133461,16174
142,41.67646362722701,1000,0.4907693883854626,13.586517555713653,17174
143,-82.11286696893144,129,0.4883155414435353,12.091387737989425,17303
144,-59.303986639261616,120,0.4858739637363176,13.612154678106307,17423
145,-215.01021615394097,135,0.483444593917636,12.983699330091476,17558
146,-44.068864685039294,144,0.4810273709480478,17.57801213502884,17702
147,-23.284133945718878,132,0.47862223409330756,16.8857049036026,17834
148,11.216980181421903,100,0.47622912292284103,12.383617960214615,17934
149,-26.97614658297475,184,0.4738479773082268,16.180607162714004,18118
150,-16.595407811441646,157,0.47147873742168567,12.16193854212761,18275
151,-310.05466507648134,581,0.46912134373457726,14.022866936922073,18856
152,0.23594890102861887,1000,0.46677573701590436,12.400169574022293,19856
153,6.455808032880341,127,0.46444185833082485,12.28859955072403,19983
154,-30.469241696378702,151,0.46211964903917074,15.165238798856736,20134
155,-29.884283801272133,146,0.4598090507939749,12.600225021839142,20280
156,-71.10866741944746,190,0.457510005540005,11.147157878875733,20470
157,-12.90411547483454,205,0.45522245551230495,12.493643465042114,20675
158,7.825743002019578,126,0.4529463432347434,12.984289289712907,20801
159,-39.760530741725134,234,0.4506816115185697,13.272223213911056,21035
160,7.146498498775358,182,0.4484282034609769,10.655604085922242,21217
161,-60.020112293897185,74,0.446186062443672,14.853617761135101,21291
162,9.76690689652142,134,0.4439551321314536,11.895791317224502,21425
163,-23.731640695376726,141,0.4417353564707963,14.488494296073913,21566
164,18.500774710308704,104,0.43952667968844233,13.873143475055695,21670
165,-30.503640778466163,168,0.43732904629000013,11.086050254106521,21838
166,-281.27665766600205,988,0.4351424010585501,13.041510376930237,22826
167,-15.562079430717963,1000,0.43296668905325736,14.644649866819382,23826
168,41.7102564928742,1000,0.43080185560799106,16.050827016830443,24826
169,9.939373009104997,182,0.4286478463299511,13.495407037734985,25008
170,-53.298066219233554,99,0.42650460709830135,18.787466270923616,25107
171,224.7460037341653,477,0.42437208406280985,20.812651438713075,25584
172,-61.020340561622234,165,0.4222502236424958,16.731413831710814,25749
173,-19.149397556173625,171,0.42013897252428334,18.5403520321846,25920
174,99.45442614608717,1000,0.4180382776616619,19.753186649084093,26920
175,-46.69169244404222,124,0.4159480862733536,19.208169691562652,27044
176,-128.94338847913735,348,0.41386834584198684,18.879610500335694,27392
177,-54.914314707694984,128,0.4117990041127769,21.320307624340057,27520
178,-24.67862791054538,1000,0.40974000909221303,23.89514067530632,28520
179,-33.090112121947854,194,0.40769130904675194,21.361256816387176,28714
180,43.984079804343224,140,0.40565285250151817,27.84465045928955,28854
181,-10.561537605019012,137,0.4036245882390106,22.77958223104477,28991
182,-47.67753272836602,143,0.4016064652978155,18.935330102443697,29134
183,22.636058748788017,1000,0.3995984329713264,26.62965742588043,30134
184,33.906749799183686,1000,0.3976004408064698,21.15345734357834,31134
185,-14.313238564776583,112,0.39561243860243744,23.83967776298523,31246
186,-62.55433191076378,104,0.3936343764094253,22.95119430780411,31350
187,-5.499342729228502,162,0.39166620452737816,24.294474329948425,31512
188,-2.0440813400821725,162,0.3897078735047413,24.696173615455628,31674
189,76.07542945036997,1000,0.3877593341372176,15.666284656524658,32674
190,-4.7308884807843725,114,0.3858205374665315,21.331660439968108,32788
191,-0.3537042711910121,1000,0.38389143477919885,18.93091720342636,33788
192,15.31983985474146,118,0.3819719776053028,22.84765243768692,33906
193,95.03747823946962,1000,0.3800621177172763,19.527672309875488,34906
194,27.54151706782777,93,0.37816180712868996,19.55052563428879,34999
195,69.57551929099921,1000,0.37627099809304654,25.941685732603073,35999
196,-1.2065120991267975,115,0.3743896431025813,23.207091114521027,36114
197,-22.395638970665928,100,0.37251769488706843,32.86174354314804,36214
198,-163.0341738213939,113,0.3706551064126331,25.05993287086487,36327
199,58.63978277823898,1000,0.36880183088056995,17.448052656650543,37327
200,-24.74162555798489,142,0.3669578217261671,26.119445099830628,37469
201,22.489853827305986,1000,0.36512303261753626,23.46742207288742,38469
202,-257.9788274367706,311,0.3632974174544486,19.20491996049881,38780
203,96.70204423984015,1000,0.3614809303671764,24.79568299293518,39780
204,140.0276778809107,1000,0.3596735257153405,20.534088730812073,40780
205,97.04429449388319,1000,0.3578751580867638,20.811139667034148,41780
206,37.65649215232236,100,0.35608578229633,24.860033769607544,41880
207,123.62880942690883,1000,0.3543053533848483,22.175173687934876,42880
208,18.45348749190103,113,0.35253382661792404,23.493717510700225,42993
209,-31.9373856222266,169,0.3507711574848344,14.64146584868431,43162
210,121.60173673534182,1000,0.34901730169741024,26.11433467388153,44162
211,-36.52367846579054,308,0.3472722151889232,25.46889914393425,44470
212,-152.53702624391258,122,0.3455358541129786,29.125449903011322,44592
213,22.4914302830648,169,0.3438081748424137,17.974534232616424,44761
214,17.423653832893237,1000,0.3420891339682016,22.382291033267975,45761
215,-25.230373991397087,150,0.3403786882983606,22.90771350502968,45911
216,-6.0026360705310395,153,0.3386767948568688,17.031389120817185,46064
217,19.661337158612056,1000,0.33698341088258443,20.691160583496092,47064
218,118.8739184254374,1000,0.3352984938281715,15.437036378383636,48064
219,14.471691077128355,122,0.33362200135903064,18.870743576288223,48186
220,40.11993903890186,87,0.33195389135223546,23.215788168907167,48273
221,160.03656943246756,1000,0.3302941218954743,22.341917963027953,49273
222,-123.35194677287902,314,0.32864265128599696,19.34743893623352,49587
223,-34.476292865184945,117,0.326999438029567,23.3469811463356,49704
224,71.24088474500694,1000,0.3253644408394192,16.996563065052033,50704
225,-78.89964877160045,692,0.3237376186352221,26.185423278808592,51396
226,228.52654999922572,234,0.322118930542046,16.709763610363005,51630
227,102.07486335385994,1000,0.32050833588933575,21.66342489719391,52630
228,-81.60609393997461,81,0.31890579420988907,19.850127981901167,52711
229,-24.7774975286562,106,0.3173112652388396,20.440664099454878,52817
230,-198.88021989176397,284,0.3157247089126454,16.75750786662102,53101
231,-86.60249848444268,580,0.3141460853680822,24.347536528110503,53681
232,-66.29923926338469,349,0.3125753549412418,25.267526795864104,54030
233,-9.562852694995769,123,0.31101247816653554,26.905128717422485,54153
234,138.45457457184085,1000,0.30945741577570285,25.425312881469726,55153
235,61.302580026970745,1000,0.3079101286968243,24.983960916996,56153
236,-23.540812678074147,161,0.3063705780533402,24.118834655284882,56314
237,29.687568749623665,1000,0.30483872516307353,26.551615896224977,57314
238,-157.77856637688308,157,0.3033145315372582,15.375733077526093,57471
239,243.30227550249504,826,0.3017979588795719,22.055054357051848,58297
240,187.2992808272444,498,0.30028896908517405,23.215164005756378,58795
241,97.28572141349669,1000,0.2987875242397482,25.284227619171144,59795
242,117.41931443360193,1000,0.29729358661854943,31.724631152153016,60795
243,33.19683778637821,167,0.29580711868545667,25.621275873184203,60962
244,100.72791455653659,1000,0.2943280830920294,34.14777495622635,61962
245,-22.544277430391148,114,0.29285644267656924,26.281562542915346,62076
246,95.14043491123995,1000,0.2913921604631864,17.51675127506256,63076
247,45.43570858498481,139,0.28993519966087045,13.408435649871826,63215
248,-35.900680552805525,106,0.2884855236625661,19.80809404373169,63321
249,127.17412590655576,1000,0.28704309604425327,29.66962248325348,64321
250,0.16699387016623746,111,0.285607880564032,18.37742037534714,64432
251,-54.88266220535124,125,0.28417984116121187,17.12690227031708,64557
252,56.95246074037328,190,0.2827589419554058,15.824849840402603,64747
253,155.09319415224687,1000,0.28134514724562876,18.301328630447387,65747
254,-42.99433935451363,107,0.2799384215094006,19.700017671585083,65854
255,151.31968065796508,1000,0.27853872940185365,19.89280092716217,66854
256,-43.34192554921672,152,0.27714603575484437,17.54329350709915,67006
257,-24.98782786617332,104,0.2757603055760701,27.13337732076645,67110
258,138.85310180262715,1000,0.2743815040481898,19.25869134426117,68110
259,-207.55104278366895,165,0.2730095965279488,18.98718950986862,68275
260,135.82018027023918,1000,0.27164454854530906,22.23524800300598,69275
261,71.69717401686323,1000,0.2702863258025825,20.75480318546295,70275
262,115.39593004486176,1000,0.2689348941735696,25.156373581886292,71275
263,145.3046847824928,1000,0.26759021970270175,22.907934546470642,72275
264,129.2357317815287,1000,0.2662522686041882,13.825648183822631,73275
265,-78.76511251114853,159,0.2649210072611673,19.478850483894348,73434
266,115.94603172008043,1000,0.26359640222486147,29.17035620570183,74434
267,125.45962068988254,1000,0.26227842021373715,20.76323792219162,75434
268,112.31702732689658,1000,0.2609670281126685,18.835779975652695,76434
269,272.3673153440399,457,0.25966219297210513,10.004584523439407,76891
270,120.06500993589805,1000,0.2583638820072446,12.322275115251541,77891
271,117.36050755209794,1000,0.2570720625972084,13.647750291824341,78891
272,-165.16483073213112,116,0.25578670228422234,8.53874153137207,79007
273,131.82824828152175,1000,0.25450776877280124,14.18970043838024,80007
274,123.93583299041569,1000,0.2532352299289372,19.006810435056686,81007
275,48.27776658590969,156,0.2519690537792925,11.391468794345856,81163
276,153.78028122266207,1000,0.2507092085103961,17.56457500100136,82163
277,93.99053885820607,1000,0.2494556624678441,15.212847312688828,83163
278,84.24049386988952,1000,0.24820838415550486,18.14914236664772,84163
279,160.76851232014565,1000,0.24696734223472733,12.055679015517235,85163
280,115.28647033026225,1000,0.2457325055235537,12.344021248817445,86163
281,13.517177022014167,104,0.24450384299593592,13.594657417535782,86267
282,-112.93368165136872,750,0.24328132378095624,6.615688879489898,87017
283,50.695591202302225,1000,0.24206491716205145,12.549399770498276,88017
284,110.84713266892624,1000,0.2408545925762412,17.30905497789383,89017
285,-196.0945413696712,102,0.23965031961336,9.857424119710922,89119
286,-20.600446738878375,204,0.2384520680152932,13.467732064723968,89323
287,38.8158779876311,121,0.23725980767521673,12.054502621889114,89444
288,230.4625366942488,892,0.23607350863684065,8.765525789260865,90336
289,-12.737401657188997,152,0.23489314109365644,14.45612660765648,90488
290,1.3934274118391272,101,0.23371867538818816,12.37690739095211,90589
291,114.29503048384062,1000,0.23255008201124722,16.831790821552275,91589
292,-59.090399192217824,102,0.231387331601191,17.07717942237854,91691
293,-54.34280819526087,142,0.23023039494318503,9.203857241868972,91833
294,-5.239942479484682,163,0.2290792429684691,12.645793579816818,91996
295,-58.279505071011855,92,0.22793384675362674,15.722207955121995,92088
296,204.57773059548305,614,0.22679417751985861,13.052706728577613,92702
297,9.661159753183185,118,0.22566020663225933,9.278916558027268,92820
298,164.55910969919532,1000,0.22453190559909803,12.400111874341965,93820
299,-346.56130237237943,148,0.22340924607110255,12.665202782154083,93968
300,-5.998817173135635,117,0.22229219984074702,13.659281626343727,94085
301,105.02447484131497,1000,0.2211807388415433,15.169058694839478,95085
302,32.9558366580375,139,0.22007483514733558,19.020809071063994,95224
303,38.090231199536305,118,0.2189744609715989,12.833908911943436,95342
304,232.34490918629368,730,0.2178795886667409,11.45161111831665,96072
305,291.2288238936334,190,0.2167901907234072,12.225458107590676,96262
306,209.30699834188408,322,0.21570623976979014,11.372714371681214,96584
307,-241.583730458166,265,0.21462770857094118,11.386418014764786,96849
308,71.09485529245238,1000,0.21355457002808648,16.587289522886277,97849
309,-124.76147058172995,528,0.21248679717794605,20.566461393237113,98377
310,139.58472055570417,1000,0.21142436319205632,7.86458295583725,99377
311,95.76453631308875,1000,0.21036724137609603,6.144306769371033,100377
312,141.5006584586683,1000,0.20931540516921554,11.830222635865212,101377
313,18.824390241835992,1000,0.20826882814336947,12.764603615999222,102377
314,122.33819297972383,1000,0.20722748400265262,11.634803577661515,103377
315,-32.66160389352447,114,0.20619134658263935,15.1961125010252,103491
316,85.57118567060212,1000,0.20516038984972615,11.008150670528412,104491
317,144.83148945276545,850,0.2041345879004775,4.5085850149393085,105341
318,158.55435871485577,911,0.2031139149609751,14.60916088461876,106252
319,241.70856756616752,420,0.20209834538617025,12.2136699873209,106672
320,219.26328076450778,768,0.2010878536592394,7.551381611227989,107440
321,289.14385141152866,732,0.2000824143909432,10.567966371774673,108172
322,93.48061756484823,1000,0.19908200231898848,12.40973192512989,109172
323,245.55615268764325,521,0.19808659230739353,6.69705052614212,109693
324,-8.728800533634882,98,0.19709615934585656,13.192748776674271,109791
325,253.63593569698708,247,0.19611067854912728,11.074539338350297,110038
326,221.7747627188929,934,0.19513012515638165,11.249263411164284,110972
327,19.706877777209655,144,0.19415447453059972,8.670519012212754,111116
328,216.99848681024096,859,0.19318370215794672,12.007333077788353,111975
329,-26.178208335817715,114,0.192217783647157,7.399234471917152,112089
330,-67.10326477152208,367,0.1912566947289212,12.492251442074776,112456
331,259.37208719759485,478,0.1903004112552766,7.805410332083702,112934
332,152.7548814225264,1000,0.18934890919900021,8.047489224076271,113934
333,240.82245910847018,572,0.18840216465300522,7.23202957034111,114506
334,11.014779374767485,101,0.18746015382974018,14.90069719851017,114607
335,29.774456400123682,116,0.1865228530605915,5.62744087100029,114723
336,289.3338995014918,289,0.18559023879528855,10.166796752810479,115012
337,21.784666452737653,116,0.1846622876013121,7.035751762986183,115128
338,3.418991615917875,116,0.18373897616330553,11.334556015729904,115244
339,40.82753248986248,118,0.182820281282489,11.150620558857918,115362
340,247.3524899871656,226,0.18190617987607657,12.53558035850525,115588
341,112.16555496471108,1000,0.18099664897669618,12.671218801736831,116588
342,106.45774847133556,1000,0.1800916657318127,7.86084224164486,117588
343,273.88284298121016,323,0.17919120740315364,7.630329167246819,117911
344,254.8218442250129,461,0.17829525136613786,6.6440991532802585,118372
345,121.51593966361176,1000,0.17740377510930716,10.704743432998658,119372
346,48.53934960513229,96,0.17651675623376062,9.351223493814468,119468
347,264.5278950140332,268,0.1756341724525918,9.330580078363418,119736
348,296.7113192915946,402,0.17475600159032884,11.352089080214501,120138
349,161.4554701952472,1000,0.17388222158237718,9.065098770856856,121138
350,265.854332812584,955,0.1730128104744653,10.027158910632133,122093
351,272.1974152425606,298,0.17214774642209296,15.28401180267334,122391
352,220.85630841738384,775,0.1712870076899825,15.185980870127677,123166
353,235.19480715900167,664,0.17043057265153258,17.426967687606812,123830
354,-16.0471504046578,167,0.16957841978827493,14.0719355905056,123997
355,244.9444622493232,259,0.16873052768933355,14.839483941197395,124256
356,251.89983472284547,739,0.1678868750508869,12.632191535830497,124995
357,-167.63323346970793,297,0.16704744067563246,15.849169067144395,125292
358,93.01309506326864,1000,0.1662122034722543,18.588514690995215,126292
359,254.27023444217485,337,0.16538114245489302,11.818276279568671,126629
360,212.61763351672153,190,0.16455423674261854,14.411680086255073,126819
361,34.141918412658754,124,0.16373146555890544,12.299097731113434,126943
362,-33.63360738211641,90,0.16291280823111093,19.878219997286795,127033
363,-226.53724186268025,292,0.16209824418995536,18.60776655435562,127325
364,-169.36389972972054,1000,0.16128775296900558,15.981996749639512,128325
365,232.49724708638385,870,0.16048131420416054,14.096039115190505,129195
366,24.962421483596028,1000,0.15967890763313974,18.620113252401353,130195
367,-48.300098449529685,122,0.15888051309497406,11.724673852920532,130317
368,281.8490951271326,325,0.1580861105294992,14.145106649398803,130642
369,-5.076406464128098,104,0.1572956799768517,19.084863535165788,130746
370,25.058373067952985,127,0.15650920157696743,10.033342715501785,130873
371,0.07405536543897995,150,0.1557266555690826,13.755373833179474,131023
372,-19.275034169322552,107,0.1549480222912372,13.980763230323792,131130
373,263.82561539271427,661,0.15417328217978102,12.972100089788437,131791
374,221.44973328264285,815,0.1534024157688821,13.759551958441735,132606
375,218.6762040298309,632,0.1526354036900377,17.894406351447106,133238
376,98.35917360893816,696,0.1518722266715875,12.124923520088196,133934
377,126.36143124639275,1000,0.15111286553822956,16.060229972600936,134934
378,-147.92655684524536,150,0.15035730121053842,15.984225887656212,135084
379,218.56520792903183,788,0.14960551470448571,16.570024811029434,135872
380,116.03591221302365,1000,0.14885748713096328,13.070042153596878,136872
381,-307.31086738629307,556,0.14811319969530845,11.983172262907027,137428
382,269.86339213397173,169,0.1473726336968319,13.75463509619236,137597
383,-202.4794678841393,191,0.14663577052834775,15.721672804355622,137788
384,263.5286582879867,163,0.14590259167570602,15.719652149677277,137951
385,247.16666153911285,200,0.1451730787173275,14.37462545633316,138151
386,244.2493365525249,614,0.14444721332374086,17.311842158436775,138765
387,43.9970497237414,1000,0.14372497725712216,25.14240238547325,139765
388,-192.96170178022436,95,0.14300635237083656,11.21196925997734,139860
389,-200.90334700759826,812,0.14229132060898236,20.37563802957535,140672
390,218.41417523856674,345,0.14157986400593744,11.952341102361679,141017
391,-10.719613299630304,1000,0.14087196468590776,10.762166755199432,142017
392,-35.009976906774085,113,0.14016760486247823,13.268502768278122,142130
393,240.56048233374509,906,0.13946676683816583,21.369461124539374,143036
394,73.95298268273919,1000,0.138769433003975,14.773398114442825,144036
395,-132.39729340654276,99,0.13807558583895513,8.97825212419033,144135
396,289.52128402669365,183,0.13738520790976036,13.104149290919304,144318
397,-5.876445293434415,98,0.13669828187021155,13.656970049142837,144416
398,11.428913358669504,98,0.13601479046086049,16.988633149862288,144514
399,301.13392197845576,209,0.1353347165085562,17.753040739297866,144723
400,-89.70342706072591,175,0.1346580429260134,15.043586473464966,144898
401,4.638883536073976,108,0.13398475271138335,8.010446473360062,145006
402,230.9208942649101,510,0.13331482894782642,23.895171145796777,145516
403,8.768050978573797,142,0.13264825480308728,20.40560311675072,145658
404,275.5497305626596,583,0.13198501352907185,16.608417364358903,146241
405,166.34703216487372,901,0.1313250884614265,12.14127498626709,147142
406,-162.85101413842634,204,0.13066846301911936,15.938437012434006,147346
407,22.687315071006324,121,0.13001512070402377,16.44404774904251,147467
408,-108.8985086257636,78,0.12936504510050365,12.569920918941499,147545
409,-500.1243509830811,81,0.12871821987500112,22.027547072172165,147626
410,5.680115756112215,99,0.12807462877562611,24.651767271757127,147725
411,-39.56599788806332,143,0.12743425563174798,14.948451316356659,147868
412,-382.82266065902957,331,0.12679708435358925,13.154339727163315,148199
413,275.2248619180952,450,0.1261630989318213,32.00713567614555,148649
414,-236.9906282283595,118,0.1255322834371622,21.02377059340477,148767
415,271.8509009676182,395,0.12490462201997637,20.941867849826814,149162
416,-254.15590586271716,113,0.1242800989098765,24.89253674030304,149275
417,-260.79794905901747,99,0.12365869841532712,20.58142172694206,149374
418,-100.02599579850238,116,0.12304040492325048,19.652648348808288,149490
419,-15.160512287552763,133,0.12242520289863423,12.26624477148056,149623
420,205.60559657196495,702,0.12181307688414106,22.548952482938766,150325
421,-215.03781713707474,153,0.12120401149972035,17.22387139201164,150478
422,162.07169508881844,921,0.12059799144222175,23.083421092033387,151399
423,160.10110916708652,844,0.11999500148501063,29.228662353754043,152243
424,294.23821203582247,285,0.11939502647758558,14.581323049068452,152528
425,206.94864880241911,428,0.11879805134519765,14.625501964092255,152956
426,4.055153963341823,173,0.11820406108847166,15.789895673394204,153129
427,-54.47453915096747,124,0.1176130407830293,15.834722504615783,153253
428,222.70666442583726,404,0.11702497557911415,19.17963429570198,153657
429,252.6675837481217,524,0.11643985070121858,21.086205558776854,154181
430,126.00607157087086,1000,0.11585765144771248,14.422621177434921,155181
431,248.41180350482935,337,0.11527836319047392,16.5425658929348,155518
432,261.13354753626044,302,0.11470197137452155,26.00207797408104,155820
433,186.3487735798168,697,0.11412846151764894,14.285310407280923,156517
434,-167.31124829804241,238,0.1135578192100607,23.6276562666893,156755
435,237.2301008161704,418,0.11299003011401039,22.108939135074614,157173
436,281.0121968964072,289,0.11242507996344034,13.905323771238328,157462
437,-11.815016502759676,113,0.11186295456362313,15.387270197868347,157575
438,249.07115430010901,368,0.11130363979080501,18.833959732055664,157943
439,248.27545486997008,440,0.11074712159185099,27.204256703853606,158383
440,265.04761117595365,219,0.11019338598389174,21.725619102716447,158602
441,-216.11845204409988,138,0.10964241905397228,12.789728200435638,158740
442,13.49739543563578,122,0.10909420695870241,16.05609974861145,158862
443,-53.2338448955703,115,0.1085487359239089,19.313326226472853,158977
444,255.2965499700593,433,0.10800599224428936,19.338807035684585,159410
445,282.28769080900577,260,0.10746596228306791,20.42752570748329,159670
446,-150.4037124080942,207,0.10692863247165257,18.198499128222466,159877
447,-16.980066725986077,85,0.1063939893092943,26.77905723333359,159962
448,263.65022554383114,262,0.10586201936274783,18.255406347513198,160224
449,43.89246205004417,129,0.10533270926593409,27.018383307456972,160353
450,153.93032931341773,775,0.10480604571960442,25.93984171807766,161128
451,29.83342111655014,107,0.1042820154910064,22.518955636024476,161235
452,281.29284671106103,458,0.10376060541355137,17.519453699588777,161693
453,191.09836928365746,357,0.1032418023864836,23.02245542407036,162050
454,271.3255369215462,274,0.10272559337455119,20.05039155244827,162324
455,-24.616307451073865,89,0.10221196540767843,20.987192387580873,162413
456,304.2428095738628,278,0.10170090558064004,19.923719816207885,162691
457,258.7297551864025,275,0.10119240105273684,25.256349709033966,162966
458,288.4291294196413,209,0.10068643904747315,13.133716876506805,163175
459,32.95857191582974,122,0.10018300685223579,17.19960824251175,163297
460,-34.20696207762059,122,0.0996820918179746,13.566686943769454,163419
461,217.0794469009799,218,0.09918368135888474,24.04302020430565,163637
462,282.2850625418447,261,0.09868776295209031,18.561622262001038,163898
463,247.67780936233086,190,0.09819432413732986,32.520327286720274,164088
464,179.44875666017657,269,0.09770335251664321,23.95062255740166,164357
465,-200.36603915587534,432,0.09721483575406,25.727356725931166,164789
466,229.1573638572749,502,0.09672876157528969,22.911284759044648,165291
467,-123.4926792534752,113,0.09624511776741324,32.33780383825302,165404
468,54.81327189587708,93,0.09576389217857617,25.18062510728836,165497
469,287.3138192584822,282,0.09528507271768329,19.718694751262664,165779
470,282.30766877225756,201,0.09480864735409487,10.442817084789276,165980
471,-70.34906695493909,65,0.0943346041173244,19.028432871103288,166045
472,235.31600564344143,316,0.09386293109673778,22.42706709623337,166361
473,-67.02018818724396,91,0.09339361644125409,30.033285143375398,166452
474,225.68124032143575,257,0.09292664835904782,20.066828584671022,166709
475,287.4987963057123,222,0.09246201511725258,23.48582344651222,166931
476,305.0125877895915,249,0.09199970504166631,26.035357332229616,167180
477,270.3466650584328,484,0.09153970651645797,23.374544689655306,167664
478,262.3116618246489,213,0.09108200798387568,27.955987650156022,167877
479,277.96194128104355,236,0.0906265979439563,16.36305934906006,168113
480,248.76947715488294,503,0.09017346495423652,19.50374016880989,168616
481,-0.6593654141317131,160,0.08972259762946533,34.658443746566775,168776
482,267.37079162775854,310,0.089273984641318,20.700460609197616,169086
483,212.5567018109885,191,0.0888276147181114,18.18487991929054,169277
484,258.52581953140293,301,0.08838347664452084,27.50520250916481,169578
485,255.7160759813387,275,0.08794155926129824,17.46747711420059,169853
486,280.49251181711367,211,0.08750185146499175,35.34262496113777,170064
487,285.52303285019264,239,0.08706434220766679,25.633475021123886,170303
488,256.802203243525,663,0.08662902049662846,17.551438138484954,170966
489,257.325576732634,191,0.08619587539414532,19.5232177901268,171157
490,24.045149412405763,193,0.08576489601717459,38.45072784662247,171350
491,213.13674326287284,184,0.08533607153708872,14.816393859386444,171534
492,147.75510611090013,851,0.08490939117940327,30.594444860219955,172385
493,-24.202140575980124,176,0.08448484422350626,16.56650471687317,172561
494,311.11194353728365,340,0.08406242000238873,19.69789152622223,172901
495,298.18976199424094,201,0.08364210790237678,17.311153622865678,173102
496,-149.3755820061502,102,0.0832238973628649,22.90370202302933,173204
497,229.87256260536657,477,0.08280777787605056,20.19141987204552,173681
498,212.12522765045355,339,0.08239373898667031,21.52270805478096,174020
499,269.1750765673875,330,0.08198177029173696,17.59606038093567,174350
500,271.59045287408685,256,0.08157186144027828,15.212625982761383,174606
501,90.25254799210207,1000,0.0811640021330769,21.664626399278642,175606
502,231.87804951711917,697,0.08075818212241151,17.386573880910873,176303
503,231.77990835203002,504,0.08035439121179945,20.512082970142366,176807
504,170.86973327568103,615,0.07995261925574046,15.918758047819138,177422
505,196.52202633572472,433,0.07955285615946175,16.095699142217637,177855
506,22.962358863469206,155,0.07915509187866444,26.164845526218414,178010
507,299.51914570992824,247,0.07875931641927113,21.418722093105316,178257
508,260.3363959284003,578,0.07836551983717477,20.103352338075638,178835
509,204.918278695308,293,0.07797369223798889,17.741079993247986,179128
510,236.8719687491433,353,0.07758382377679894,13.105003790855408,179481
511,187.9023413462944,542,0.07719590465791494,18.868850593566894,180023
512,283.89789256243307,292,0.07680992513462537,23.427437247037886,180315
513,232.17812202581328,271,0.07642587550895225,17.304161524772645,180586
514,231.93997155241073,286,0.07604374613140748,18.15811694979668,180872
515,202.141357997735,451,0.07566352740075044,16.535978865623473,181323
516,226.1502671432024,311,0.07528520976374668,24.694357817173003,181634
517,260.0472809860824,639,0.07490878371492794,14.002733758687974,182273
518,246.5719140070392,444,0.0745342397963533,28.50946615934372,182717
519,245.21196927974893,475,0.07416156859737154,19.083273856639863,183192
520,95.41979486007884,1000,0.07379076075438468,21.17848510503769,184192
521,-100.8088442994872,305,0.07342180695061275,19.844712016582488,184497
522,261.3316738529994,423,0.07305469791585968,15.889177576303481,184920
523,49.6001027967051,212,0.07268942442628039,16.943283643722534,185132
524,303.5605203815809,370,0.07232597730414898,23.82217420220375,185502
525,227.1075631294976,641,0.07196434741762824,23.555307161808013,186143
526,274.1721985641127,331,0.0716045256805401,19.549228403568268,186474
527,240.35885463961813,347,0.0712465030521374,27.592034466266632,186821
528,263.6903090713146,363,0.0708902705368767,13.889388628005982,187184
529,191.87657078459682,536,0.07053581918419231,22.154810378551485,187720
530,176.48234428618423,673,0.07018314008827135,19.70378394603729,188393
531,235.90970373436073,207,0.06983222438783,18.659452962875367,188600
532,268.92317850223867,251,0.06948306326589085,16.561771723032,188851
533,233.09629174915926,407,0.0691356479495614,18.174168713092804,189258
534,52.35977555360614,164,0.06878996970981359,25.024413278102873,189422
535,272.750553812381,286,0.06844601986126451,21.451614688634873,189708
536,210.77020043979024,545,0.06810378976195819,16.678843117952347,190253
537,235.13729499105773,364,0.0677632708131484,17.32384044408798,190617
538,285.4059436627289,197,0.06742445445908266,15.03535213470459,190814
539,261.5193646225671,172,0.06708733218678724,24.682089846134186,190986
540,251.22139674937296,219,0.0667518955258533,11.956685754060745,191205
541,288.01767981908995,388,0.06641813604822402,31.88937344312668,191593
542,247.69405968570874,291,0.0660860453679829,23.903713085651397,191884
543,262.84142830122425,404,0.06575561514114299,21.84182692527771,192288
544,-18.388150907705878,150,0.06542683706543727,18.37936766386032,192438
545,256.1823938045403,183,0.06509970288011008,13.718440073132514,192621
546,3.8886844577298234,140,0.06477420436570952,33.1112710082531,192761
547,295.0012543515519,411,0.06445033334388098,23.167663481235504,193172
548,263.1770642178898,233,0.06412808167716157,13.109841407537461,193405
549,259.043893951215,463,0.06380744126877576,27.249818480014802,193868
550,281.29278236133945,225,0.06348840406243188,18.95405443906784,194093
551,294.76551194571675,395,0.06317096204211972,24.2729434299469,194488
552,259.72830614807077,624,0.06285510723190912,20.401608686447144,195112
553,278.7674723206036,189,0.06254083169574957,14.525460588932038,195301
554,285.8313698859195,148,0.062228127537270826,18.47142858862877,195449
555,290.32203256657067,471,0.06191698689958447,19.848096463680267,195920
556,250.88544262549618,249,0.061607401965086545,13.242290667295457,196169
557,303.34741175723036,231,0.06129936495526111,23.17202598810196,196400
558,291.1058187412604,258,0.0609928681304848,16.01082443833351,196658
559,222.66602144560653,305,0.060687903789832374,15.567212247252463,196963
560,281.4685656740278,304,0.06038446427088321,16.199330508708954,197267
561,269.2903510228869,381,0.06008254194952879,18.650617407560347,197648
562,259.8203778038944,198,0.05978212923978115,12.440092918276786,197846
563,14.713209625003799,186,0.05948321859358224,22.610186849832534,198032
564,260.8583948116469,230,0.05918580250061433,17.854316427707673,198262
565,243.6500671379446,258,0.058889873488111255,12.005569915175437,198520
566,230.23970624829994,324,0.058595424120670696,26.20532305717468,198844
567,252.80864199063816,214,0.05830244700006734,17.756863874197006,199058
568,294.7541409548419,320,0.058010934765067,13.43436528325081,199378
569,-15.888173523514183,183,0.05772088009124167,20.706387746334077,199561
570,235.94062834283812,282,0.05743227569078546,24.855107654333114,199843
571,247.2498263396712,179,0.05714511431233153,17.70549223780632,200022
