episode,reward,length,epsilon,mean_loss,steps
1,-116.1442658151375,120,0.995,3.2174382380076816,120
2,-132.84558090703865,84,0.990025,59.44711158514023,204
3,-465.7600451396845,99,0.985074875,71.36476051330567,303
4,-401.5057178083919,130,0.9801495006250001,33.075786859989165,433
5,-252.45644134243668,95,0.9752487531218751,53.659645538330075,528
6,-231.8457666163466,101,0.9703725093562657,44.49675391435623,629
7,-381.14720523306914,103,0.9655206468094844,79.99572994232177,732
8,-289.9336622297094,70,0.960693043575437,70.05451221466065,802
9,-188.11806983197286,90,0.9558895783575597,235.62948429107666,892
10,-154.87895482756772,106,0.9511101304657719,184.95489384651185,998
11,-125.60514628291901,77,0.946354579813443,146.51690521240235,1075
12,-407.19598426503603,94,0.9416228069143757,137.36091326236726,1169
13,-126.29189548271721,85,0.9369146928798039,112.40491753339768,1254
14,-154.78646132157803,102,0.9322301194154049,111.05333990812302,1356
15,-83.03867711319215,141,0.9275689688183278,87.32315020442009,1497
16,-72.7361450323345,82,0.9229311239742362,96.13835581421853,1579
17,-276.0524408280604,98,0.918316468354365,95.66914659976959,1677
18,-88.34640184657084,107,0.9137248860125932,109.33542061924935,1784
19,-166.26332001541175,107,0.9091562615825302,73.12037440538407,1891
20,4.608675415266035,80,0.9046104802746175,94.99801311254501,1971
21,-78.31185194719015,109,0.9000874278732445,105.58833117961883,2080
22,-195.5951859970465,100,0.8955869907338783,95.3088316655159,2180
23,-81.85081270435165,78,0.8911090557802088,101.7314409828186,2258
24,-98.97372625110101,68,0.8866535105013078,78.48746767759323,2326
25,-52.580561360884246,83,0.8822202429488013,76.49122997045517,2409
26,-111.39043419004418,74,0.8778091417340573,73.28243364572525,2483
27,-164.39394163130703,99,0.8734200960253871,74.96014960765838,2582
28,-164.96327305889133,123,0.8690529955452602,68.78174769639969,2705
29,-156.15563062284997,110,0.8647077305675338,61.664718136787414,2815
30,-133.71789455042142,112,0.8603841919146962,52.341435322761534,2927
31,-171.43693974089297,107,0.8560822709551227,59.62076906681061,3034
32,-106.25825004930587,121,0.851801859600347,49.4350517821312,3155
33,-112.73214369896705,101,0.8475428503023453,69.99619312286377,3256
34,-98.30996729495777,128,0.8433051360508336,41.37631786465645,3384
35,-119.29728034716695,82,0.8390886103705794,34.69854350447655,3466
36,-100.22642893046219,63,0.8348931673187264,37.8739811372757,3529
37,-113.51029090343832,90,0.8307187014821328,28.683254618644714,3619
38,-256.98541504861043,82,0.8265651079747222,36.840244059562686,3701
39,-112.1383890790015,103,0.8224322824348486,28.375178515911102,3804
40,-279.69026436808946,93,0.8183201210226743,30.359184210300445,3897
41,-316.09096528685916,87,0.8142285204175609,25.6579206597805,3984
42,-105.3683966244621,85,0.810157377815473,39.11758309841156,4069
43,-68.81104430287455,134,0.8061065909263957,29.67161364197731,4203
44,-151.88797146893762,80,0.8020760579717637,25.016272505521773,4283
45,4.328470799024075,89,0.798065677681905,22.000765244960785,4372
46,-75.76878536219712,93,0.7940753492934954,30.565781509876253,4465
47,-135.72812741719522,88,0.7901049725470279,35.58699577450752,4553
48,-76.33168818313892,124,0.7861544476842928,27.83885036945343,4677
49,-168.56434165093657,74,0.7822236754458713,26.830676486492155,4751
50,-97.79123449879823,95,0.778312557068642,23.638173273801804,4846
51,-48.38044989537303,97,0.7744209942832988,25.054185897111893,4943
52,-149.22717185265867,104,0.7705488893118823,34.798826481103895,5047
53,-134.45543400213154,99,0.7666961448653229,17.30962175369263,5146
54,-51.14747033722675,72,0.7628626641409962,21.262946443557738,5218
55,-326.0798840123492,89,0.7590483508202912,14.287492569684982,5307
56,-66.44726744855748,122,0.7552531090661897,24.847827208042144,5429
57,-72.12039204419568,114,0.7514768435208588,18.997766596078872,5543
58,-249.04190835259894,135,0.7477194593032545,21.796398048400878,5678
59,-184.57752622559482,105,0.7439808620067382,15.512219744920731,5783
60,-213.87486194617338,115,0.7402609576967045,18.834645526409147,5898
61,-187.98153365764105,99,0.736559652908221,22.711842710971833,5997
62,-100.93812789710917,83,0.7328768546436799,13.439097641706466,6080
63,-111.38948616992502,95,0.7292124703704616,20.157508804798127,6175
64,-52.385231135368436,89,0.7255664080186093,16.4844225358963,6264
65,-103.38686078044486,121,0.7219385759785162,18.27250896215439,6385
66,-287.0575338912121,134,0.7183288830986236,20.512355629205704,6519
67,-44.46600942777023,151,0.7147372386831305,24.69165719985962,6670
68,-92.3356343013597,101,0.7111635524897149,22.26512919306755,6771
69,-69.05950052449583,101,0.7076077347272662,20.204290872812273,6872
70,-94.97413429358252,94,0.7040696960536299,25.588461520671846,6966
71,-28.007333887513354,135,0.7005493475733617,22.25434430837631,7101
72,-119.33869529042957,107,0.697046600835495,21.927109549045564,7208
73,-118.93904426213123,106,0.6935613678313175,23.764126694202425,7314
74,-94.69134508178637,113,0.6900935609921609,22.94434751033783,7427
75,-129.25974464447773,126,0.6866430931872001,28.72818304538727,7553
76,14.087426025777816,89,0.6832098777212641,31.691311333179474,7642
77,-128.99286451270154,109,0.6797938283326578,27.807868394851685,7751
78,-178.36501011229538,102,0.6763948591909945,25.45951383113861,7853
79,-167.7593502777268,233,0.6730128848950395,16.373021476268768,8086
80,-60.72059831129171,86,0.6696478204705644,22.41235597372055,8172
81,-54.441277952776844,130,0.6662995813682115,27.377556586265563,8302
82,-73.99419150124191,101,0.6629680834613705,19.624435682296753,8403
83,-61.56658461649274,73,0.6596532430440636,18.383773090839387,8476
84,-53.25924137086697,105,0.6563549768288433,27.277101085186004,8581
85,-86.20517465883859,99,0.653073201944699,31.83785574913025,8680
86,-17.85817538830092,143,0.6498078359349755,25.829973967075347,8823
87,-77.67117076256702,150,0.6465587967553006,21.494000577926634,8973
88,-51.4711169144975,147,0.6433260027715241,19.753844017982484,9120
89,-18.180962031176563,98,0.6401093727576664,24.38964966058731,9218
90,-29.43318832983482,114,0.6369088258938781,24.74365965843201,9332
91,-49.917778989962855,87,0.6337242817644086,26.066969141960143,9419
92,-65.09805287366025,108,0.6305556603555866,24.705825819969178,9527
93,-36.297791378968554,91,0.6274028820538087,18.892881829738617,9618
94,-55.27481782526425,94,0.6242658676435396,21.809825159311295,9712
95,-169.03377387601444,189,0.6211445383053219,23.32319540143013,9901
96,-109.78103557677895,127,0.6180388156137953,17.993695975542067,10028
97,-42.17233064834387,119,0.6149486215357263,22.400974128246308,10147
98,-77.10151298170402,126,0.6118738784280476,17.15824246406555,10273
99,-16.956173170885606,109,0.6088145090359074,22.340886590480803,10382
100,-27.532717384520865,126,0.6057704364907278,21.65439419865608,10508
101,-112.92884646414306,151,0.6027415843082742,19.048542375564576,10659
102,7.112257397532446,147,0.5997278763867329,18.81711763381958,10806
103,8.787311830593993,117,0.5967292370047992,20.686520556211473,10923
104,-137.93559833675587,127,0.5937455908197752,16.68380113840103,11050
105,-18.138873949724143,117,0.5907768628656763,14.48672213435173,11167
106,-162.72081278239102,119,0.5878229785513479,16.776924114227295,11286
107,-177.74059059410087,126,0.5848838636585911,15.864792904853822,11412
108,-58.656731250254936,128,0.5819594443402982,18.807758573293686,11540
109,-27.277729977708788,92,0.5790496471185967,13.49505847811699,11632
110,-82.52126132517773,115,0.5761543988830038,17.63457978963852,11747
111,5.589273126538899,137,0.5732736268885887,17.602646901607514,11884
112,-81.0025248871571,117,0.5704072587541458,15.204925533533096,12001
113,-58.42737109555212,112,0.567555222460375,24.006001751422883,12113
114,-44.736552579017456,108,0.5647174463480732,21.13644050836563,12221
115,-76.16213126138764,103,0.5618938591163328,13.602948138713836,12324
116,-44.80307787174391,141,0.5590843898207511,18.614943175315858,12465
117,-100.9942494852848,148,0.5562889678716474,19.3046654522419,12613
118,-79.1681636308726,116,0.5535075230322891,21.485703645944596,12729
119,-48.23348786557569,84,0.5507399854171277,23.316331263780594,12813
120,-137.10759848309579,139,0.547986285490042,14.678347444534301,12952
121,-32.574652442119174,127,0.5452463540625918,18.25304033756256,13079
122,-47.88060248605679,150,0.5425201222922789,19.921548891067506,13229
123,-51.10104355604447,130,0.5398075216808175,17.42805993437767,13359
124,-110.77193927669013,187,0.5371084840724134,21.040978195667268,13546
125,-26.106130102748622,157,0.5344229416520513,17.52709548830986,13703
126,22.61974671982928,170,0.531750826943791,20.46110840320587,13873
127,-95.7816065447704,1000,0.5290920728090721,15.616424458026886,14873
128,22.297460557243127,185,0.5264466124450268,17.192364621162415,15058
129,12.76665245013406,97,0.5238143793828016,12.632524764537811,15155
130,-83.78281075450239,172,0.5211953074858876,14.609127089977264,15327
131,-160.97111273529833,420,0.5185893309484582,19.738860510587692,15747
132,-8.349023680910435,100,0.5159963842937159,20.552651529312133,15847
133,-40.8386468552942,77,0.5134164023722473,19.53935676574707,15924
134,-67.99003229486398,84,0.510849320360386,15.964070918560028,16008
135,-17.773772529042446,121,0.5082950737585841,16.545998368263245,16129
136,-20.238455426418085,141,0.5057535983897912,18.742184236049653,16270
137,7.583267028546658,126,0.5032248303978422,19.134209234714508,16396
138,-31.641448172013554,104,0.500708706245853,16.897400166988373,16500
139,-398.9940890912143,895,0.4982051627146237,17.20101171016693,17395
140,-9.580538397635294,132,0.49571413690105054,23.583777797222137,17527
141,-23.17297907181971,221,0.4932355662165453,24.276301746368407,17748
142,-30.448205602585162,133,0.4907693883854626,22.60989612579346,17881
143,55.06662016822215,1000,0.4883155414435353,24.856435077190397,18881
144,-24.849635916919098,1000,0.4858739637363176,33.682831149101254,19881
145,-62.10757456322182,108,0.483444593917636,20.363465864658355,19989
146,11.15727997586687,105,0.4810273709480478,28.770142004489898,20094
147,-109.24456577644186,582,0.47862223409330756,26.184187562465667,20676
148,-66.76545673361363,112,0.47622912292284103,30.096400136947633,20788
149,63.076464738370674,184,0.4738479773082268,28.640293650627136,20972
150,-48.259552686606455,1000,0.47147873742168567,22.16324197769165,21972
151,-160.3674955370599,103,0.46912134373457726,30.695315709114073,22075
152,-9.099420277224812,1000,0.46677573701590436,24.99060000658035,23075
153,-93.63679381257717,1000,0.46444185833082485,23.19075732946396,24075
154,-10.342310981395514,93,0.46211964903917074,33.17776121854782,24168
155,-1.0541206237779903,142,0.4598090507939749,29.357200565338136,24310
156,24.649824321516945,120,0.457510005540005,39.35443500518799,24430
157,7.879195938542182,203,0.45522245551230495,37.12903558254242,24633
158,-17.001552587114276,143,0.4529463432347434,30.43142673969269,24776
159,42.40298506432501,118,0.4506816115185697,44.20019611120224,24894
160,-8.228060455978193,1000,0.4484282034609769,30.70505403995514,25894
161,-52.89074919706613,147,0.446186062443672,41.60048006057739,26041
162,-15.230145339528505,126,0.4439551321314536,43.12360735416412,26167
163,-19.877275079854243,104,0.4417353564707963,35.63150079011917,26271
164,23.374677490493724,133,0.43952667968844233,36.21279375553131,26404
165,3.587710362108396,119,0.43732904629000013,33.993583362102505,26523
166,13.377670386683008,1000,0.4351424010585501,29.22256899356842,27523
167,-21.608399965173675,128,0.43296668905325736,28.088650941848755,27651
168,-37.52510149079173,147,0.43080185560799106,40.294098505973814,27798
169,-44.84758746152096,119,0.4286478463299511,55.86761116504669,27917
170,-43.87730094684377,106,0.42650460709830135,54.842997245788574,28023
171,-74.54240692506568,1000,0.42437208406280985,46.199230184555056,29023
172,-98.78909900348101,86,0.4222502236424958,38.35190926551819,29109
173,53.67608509360721,158,0.42013897252428334,36.33746001958847,29267
174,-3.8535334710302322,187,0.4180382776616619,51.954232988357546,29454
175,2.0266890742883703,116,0.4159480862733536,51.39894342899323,29570
176,-80.45212461849536,77,0.41386834584198684,38.65108396053314,29647
177,35.0702763812925,91,0.4117990041127769,52.17880722522736,29738
178,28.876303047013863,150,0.40974000909221303,58.65294713973999,29888
179,-10.887455529930449,136,0.40769130904675194,40.13187407970428,30024
180,21.989930876407428,156,0.40565285250151817,51.34806183338165,30180
181,-5.509020847068863,1000,0.4036245882390106,38.87805792331696,31180
182,89.28321890855065,1000,0.4016064652978155,30.500481014251708,32180
183,10.38905361934134,119,0.3995984329713264,53.559970703125,32299
184,20.57863601684457,102,0.3976004408064698,53.361894257068634,32401
185,8.703661795973659,123,0.39561243860243744,48.011984362602234,32524
186,6.984809998439218,136,0.3936343764094253,51.15971237659454,32660
187,-22.299495574237266,1000,0.39166620452737816,33.39590884208679,33660
188,16.60534709708134,1000,0.3897078735047413,42.924587292671205,34660
189,-13.44861131200445,1000,0.3877593341372176,34.74839765548706,35660
190,-40.892783707564504,95,0.3858205374665315,46.70001825809479,35755
191,53.04502801431878,1000,0.38389143477919885,44.987641613483426,36755
192,-45.04339041480843,92,0.3819719776053028,30.07208734512329,36847
193,29.915870782195725,129,0.3800621177172763,42.86253229379654,36976
194,15.301574748494573,1000,0.37816180712868996,54.46785870552063,37976
195,-19.706263259254825,115,0.37627099809304654,32.66791837692261,38091
196,64.96789287468606,1000,0.3743896431025813,32.92517694711685,39091
197,42.313554446854766,1000,0.37251769488706843,43.22733654499054,40091
198,0.0689659704296588,107,0.3706551064126331,40.63431644916535,40198
199,28.968910660403907,1000,0.36880183088056995,42.61990200519562,41198
200,-61.23187842039614,122,0.3669578217261671,39.92284275770187,41320
201,-16.61028391704808,112,0.36512303261753626,38.26482338428497,41432
202,69.37966294531361,1000,0.3632974174544486,34.307721400260924,42432
203,-21.191528186838923,97,0.3614809303671764,39.267381682395936,42529
204,-303.1500697799928,922,0.3596735257153405,36.35615978002548,43451
205,-42.17680549230063,209,0.3578751580867638,39.10719591140747,43660
206,-216.16303269433078,234,0.35608578229633,26.97594439983368,43894
207,2.3251741287869123,124,0.3543053533848483,43.051382322311404,44018
208,-1.1461036176687853,1000,0.35253382661792404,43.23864489078522,45018
209,-8.833823909454646,1000,0.3507711574848344,34.388919479846955,46018
210,-43.136220252212645,90,0.34901730169741024,24.293854031562805,46108
211,-31.800605230436076,112,0.3472722151889232,36.152788577079775,46220
212,39.12593511559723,101,0.3455358541129786,27.47428853750229,46321
213,-26.43811004915122,108,0.3438081748424137,34.88038397789001,46429
214,-69.62708517111196,137,0.3420891339682016,40.26966025352478,46566
215,-142.3903803765447,569,0.3403786882983606,28.46471279144287,47135
216,110.27727609402,1000,0.3386767948568688,35.12074511528015,48135
217,-118.77337211374424,311,0.33698341088258443,49.212695140838626,48446
218,26.27212683762443,1000,0.3352984938281715,24.394915475845337,49446
219,48.995032175690014,1000,0.33362200135903064,39.3849189376831,50446
220,-332.0647134684533,367,0.33195389135223546,39.7738375377655,50813
221,63.73592080042358,1000,0.3302941218954743,39.03309947729111,51813
222,1.6768462849017283,78,0.32864265128599696,35.071822538375855,51891
223,43.0882640128314,1000,0.326999438029567,38.27169753551483,52891
224,-212.87766541405531,319,0.3253644408394192,37.321969656944276,53210
225,114.53748419131543,1000,0.3237376186352221,33.88306444644928,54210
226,89.04803196081991,1000,0.322118930542046,35.132683229446414,55210
227,-184.6331952340429,185,0.32050833588933575,34.31826846122742,55395
228,-80.71712923948246,136,0.31890579420988907,42.32507541418076,55531
229,-22.07494278959375,88,0.3173112652388396,36.317685995101925,55619
230,105.66328766428187,1000,0.3157247089126454,35.87883444786072,56619
231,125.89347564924911,1000,0.3141460853680822,28.848682804107668,57619
232,207.29379021688186,578,0.3125753549412418,19.995079951286314,58197
233,-266.9535567695531,626,0.31101247816653554,28.459531664848328,58823
234,59.67337722087032,1000,0.30945741577570285,33.10014941930771,59823
235,11.492047045581039,1000,0.3079101286968243,23.497701904773713,60823
236,111.81739639288793,1000,0.3063705780533402,39.346502420902254,61823
237,115.77908023466529,778,0.30483872516307353,35.21658331871033,62601
238,95.24029311111453,1000,0.3033145315372582,22.022779626846315,63601
239,247.0085575767061,924,0.3017979588795719,31.654247720241546,64525
240,-173.64920002796882,166,0.30028896908517405,32.686009166240694,64691
241,101.59466176372976,1000,0.2987875242397482,24.177486984729768,65691
242,44.34348512160389,174,0.29729358661854943,19.631161904335023,65865
243,72.19390218988802,1000,0.29580711868545667,25.740788204669954,66865
244,2.779731568479164,160,0.2943280830920294,26.589180114269258,67025
245,56.0749370211299,149,0.29285644267656924,16.53841182231903,67174
246,-14.48635908301631,85,0.2913921604631864,24.720393378734588,67259
247,120.38423655125195,1000,0.28993519966087045,24.864546418190002,68259
248,-28.13889936622401,87,0.2884855236625661,27.691592626571655,68346
249,163.53836304963787,1000,0.28704309604425327,14.873822231292724,69346
250,120.37402802601713,1000,0.285607880564032,38.88675722837448,70346
251,-11.240320362030346,73,0.28417984116121187,30.4702951836586,70419
252,129.63033986910997,1000,0.2827589419554058,21.268666758537293,71419
253,-127.11695547797987,419,0.28134514724562876,23.726450824737547,71838
254,-66.76796036649131,87,0.2799384215094006,29.78882844209671,71925
255,26.123414410523424,90,0.27853872940185365,34.194158661365506,72015
256,248.76814578810894,953,0.27714603575484437,30.064858937263487,72968
257,-10.331985754087285,92,0.2757603055760701,19.719616129398347,73060
258,51.24772042048998,1000,0.2743815040481898,20.71433666944504,74060
259,-10.179391683842425,159,0.2730095965279488,23.433833599090576,74219
260,142.29089720616625,1000,0.27164454854530906,15.899112319946289,75219
261,15.331308215298792,1000,0.2702863258025825,26.65053841114044,76219
262,8.446757118754673,1000,0.2689348941735696,18.56054130792618,77219
263,171.96631080622785,868,0.26759021970270175,17.314762721061708,78087
264,153.47363848905223,1000,0.2662522686041882,17.24535921573639,79087
265,116.50050219037894,1000,0.2649210072611673,12.620514495372772,80087
266,100.54950365928141,1000,0.26359640222486147,16.147097898721697,81087
267,157.38384032479664,1000,0.26227842021373715,11.343776942491532,82087
268,178.2489087165183,654,0.2609670281126685,15.488833609819412,82741
269,98.60135849257986,1000,0.25966219297210513,18.17811421394348,83741
270,-177.8708490937388,154,0.2583638820072446,16.43078276157379,83895
271,124.14530168351382,1000,0.2570720625972084,11.016662886142731,84895
272,119.6284692541714,1000,0.25578670228422234,14.130589612722396,85895
273,216.24291414676932,715,0.25450776877280124,21.528878501653672,86610
274,149.31266259495249,1000,0.2532352299289372,10.807720414400102,87610
275,129.10573866581942,1000,0.2519690537792925,13.23494856953621,88610
276,146.3478821374555,1000,0.2507092085103961,16.348305900096893,89610
277,114.06935766027189,1000,0.2494556624678441,14.686066105365754,90610
278,129.67734008617617,1000,0.24820838415550486,11.2116719019413,91610
279,138.21046399511715,1000,0.24696734223472733,15.108597812652588,92610
280,116.44005918479482,1000,0.2457325055235537,10.549042625427246,93610
281,147.5514720149321,1000,0.24450384299593592,15.99314423084259,94610
282,-47.94757562242134,1000,0.24328132378095624,8.870575213432312,95610
283,82.47635865881621,1000,0.24206491716205145,11.165674492120743,96610
284,258.4776429016773,394,0.2408545925762412,9.143778972625732,97004
285,121.59500832353814,1000,0.23965031961336,10.602481223344803,98004
286,32.97586903661335,89,0.2384520680152932,8.233489147424699,98093
287,140.48781254242633,1000,0.23725980767521673,7.9137351143360135,99093
288,176.49915271124794,1000,0.23607350863684065,7.934830964803695,100093
289,-136.03301760167886,246,0.23489314109365644,9.055940915346145,100339
290,99.13878298201128,1000,0.23371867538818816,7.051620537042618,101339
291,160.32937888562958,1000,0.23255008201124722,7.783354436755181,102339
292,158.7398986927724,1000,0.231387331601191,5.197261102199555,103339
293,128.66920597669085,1000,0.23023039494318503,9.07459211051464,104339
294,-80.31451231138186,98,0.2290792429684691,7.09063337802887,104437
295,153.4479507515692,1000,0.22793384675362674,6.89256136059761,105437
296,147.96950443168973,1000,0.22679417751985861,5.581997054815292,106437
297,147.2288399969153,1000,0.22566020663225933,5.984582695960999,107437
298,193.60837391802994,1000,0.22453190559909803,8.405299535393715,108437
299,-54.64256339925386,90,0.22340924607110255,6.222136564254761,108527
300,-8.730103594653372,128,0.22229219984074702,5.727467344999313,108655
301,126.13736180645353,1000,0.2211807388415433,8.965514267683028,109655
302,108.64092454018653,1000,0.22007483514733558,8.949743275046348,110655
303,142.0764929068326,1000,0.2189744609715989,9.346444036960602,111655
304,26.00690251541748,165,0.2178795886667409,9.723634655475616,111820
305,144.1631855919646,1000,0.2167901907234072,6.590449562072754,112820
306,-257.5354623735998,327,0.21570623976979014,5.280973344445228,113147
307,219.4803062239553,786,0.21462770857094118,8.987645332217216,113933
308,116.43604230839367,1000,0.21355457002808648,4.834904618263245,114933
309,51.62843243796357,134,0.21248679717794605,5.883293542265892,115067
310,16.714351065224918,91,0.21142436319205632,6.689912702441216,115158
311,150.04827235754877,1000,0.21036724137609603,5.462114907503128,116158
312,-1.098653264671043,134,0.20931540516921554,9.220665192008019,116292
313,156.52056573214108,1000,0.20826882814336947,23.485890086889267,117292
314,2.0809406672675834,94,0.20722748400265262,10.33891696214676,117386
315,150.85599099878942,1000,0.20619134658263935,10.218901911377907,118386
316,174.99503023933852,1000,0.20516038984972615,14.19849204480648,119386
317,126.61974602989991,1000,0.2041345879004775,5.24937583565712,120386
318,122.36429365145973,1000,0.2031139149609751,5.300908324122429,121386
319,13.461110258098017,138,0.20209834538617025,10.742132258415221,121524
320,57.6364259500307,1000,0.2010878536592394,14.500943703055382,122524
321,205.7902001455647,947,0.2000824143909432,3.734130698442459,123471
322,63.948531268142986,1000,0.19908200231898848,7.149017634391785,124471
323,159.7682091382091,1000,0.19808659230739353,5.945626214742661,125471
324,155.48146573535442,1000,0.19709615934585656,5.9919193947315215,126471
325,284.53089860011755,592,0.19611067854912728,4.560873835086823,127063
326,133.01434771333135,1000,0.19513012515638165,5.215740234851837,128063
327,267.3119713411546,719,0.19415447453059972,8.992085468173027,128782
328,124.19511536289076,1000,0.19318370215794672,4.0359087270498275,129782
329,156.38193945210952,1000,0.192217783647157,4.310240483283996,130782
330,112.77859801270888,1000,0.1912566947289212,3.5494472670555113,131782
331,125.81601203788878,1000,0.1903004112552766,5.0264780265092845,132782
332,188.3115896116742,665,0.18934890919900021,6.4601252436637875,133447
333,120.67113032130818,1000,0.18840216465300522,11.814917988181115,134447
334,127.48240748018684,1000,0.18746015382974018,3.4532951441407205,135447
335,179.6481861870548,1000,0.1865228530605915,13.47524645358324,136447
336,-463.5418397564021,335,0.18559023879528855,3.678433420956135,136782
337,105.6667406662376,1000,0.1846622876013121,8.772702724039554,137782
338,111.47779147988906,1000,0.18373897616330553,4.041851500868797,138782
339,-63.19467065681836,110,0.182820281282489,3.626196033358574,138892
340,107.95946540545287,1000,0.18190617987607657,6.713778938055039,139892
341,11.818893171018331,295,0.18099664897669618,4.054411984086037,140187
342,-101.8615906214582,73,0.1800916657318127,13.941483485102653,140260
343,-367.145715812178,138,0.17919120740315364,3.479273133575916,140398
344,-98.15738190010428,1000,0.17829525136613786,8.18088222682476,141398
345,-196.33343444313962,390,0.17740377510930716,11.870096668601036,141788
346,-234.737344872952,319,0.17651675623376062,10.657029255032539,142107
347,-225.39871533177165,428,0.1756341724525918,8.447456139326096,142535
348,264.78913618619674,385,0.17475600159032884,4.651897588968277,142920
349,115.55786030232147,1000,0.17388222158237718,5.717095005512237,143920
350,-148.71398227064037,154,0.1730128104744653,16.049685302972794,144074
351,271.02398661297724,853,0.17214774642209296,9.317093259692193,144927
352,239.95566076931146,257,0.1712870076899825,24.652259011268615,145184
353,233.27545467140843,383,0.17043057265153258,5.76156653046608,145567
354,-106.76427120723932,358,0.16957841978827493,5.225480152964592,145925
355,93.2901453288613,1000,0.16873052768933355,8.138526282906533,146925
356,-3.542494622837637,175,0.1678868750508869,10.482968358397484,147100
357,116.68558777003942,1000,0.16704744067563246,8.022753725647926,148100
358,144.4768721546287,1000,0.1662122034722543,8.758192532658576,149100
359,216.0331748539386,381,0.16538114245489302,10.335712935328484,149481
360,295.16638654306286,320,0.16455423674261854,12.357138429284095,149801
361,118.33301433522536,1000,0.16373146555890544,10.494927594065667,150801
362,175.66994929093428,648,0.16291280823111093,13.835328000783921,151449
363,116.52429959250986,1000,0.16209824418995536,10.229997807741166,152449
364,291.0909614951678,615,0.16128775296900558,10.76641181588173,153064
365,-189.4532133744682,188,0.16048131420416054,7.161025267243385,153252
366,-226.67950888771318,115,0.15967890763313974,8.432589731216432,153367
367,14.620434858156784,111,0.15888051309497406,9.67979380965233,153478
368,252.47824135453212,217,0.1580861105294992,10.763633378148079,153695
369,17.535933574319344,164,0.1572956799768517,13.281441219449043,153859
370,179.49141901107194,1000,0.15650920157696743,9.878653275370597,154859
371,161.98412314979515,1000,0.1557266555690826,12.67228630900383,155859
372,236.71589895381314,252,0.1549480222912372,13.864381131529807,156111
373,160.31273985404687,1000,0.15417328217978102,6.780915375053882,157111
374,156.52247281721333,1000,0.1534024157688821,6.341245285868645,158111
375,-267.2370047652943,237,0.1526354036900377,8.993295750617982,158348
376,152.3318167574952,1000,0.1518722266715875,8.312783304452896,159348
377,7.318528170181722,505,0.15111286553822956,8.667871267199516,159853
378,133.61522846791212,1000,0.15035730121053842,9.368847860693931,160853
379,146.19329409702888,1000,0.14960551470448571,7.477963833212852,161853
380,259.9537650075256,422,0.14885748713096328,10.22112117111683,162275
381,243.11511019061322,371,0.14811319969530845,4.707727158665657,162646
382,232.40854985100762,759,0.1473726336968319,9.576392785310745,163405
383,245.04229306400254,272,0.14663577052834775,7.427500268220902,163677
384,-161.61515063019553,302,0.14590259167570602,12.826453613042831,163979
385,230.77108480503063,775,0.1451730787173275,6.552894942760467,164754
386,257.746867802363,421,0.14444721332374086,6.338817192316055,165175
387,-161.18364248360467,228,0.14372497725712216,5.891444957256317,165403
388,-188.6115717481622,213,0.14300635237083656,13.709522949457169,165616
389,247.61180090599893,416,0.14229132060898236,9.714722918272019,166032
390,257.29762658637185,284,0.14157986400593744,12.457410655021668,166316
391,277.06484770106226,771,0.14087196468590776,12.132456915974617,167087
392,204.57088008137873,589,0.14016760486247823,14.250326370596886,167676
393,-76.90429712138216,132,0.13946676683816583,7.736788668036461,167808
394,262.2780175169803,700,0.138769433003975,12.361615760326385,168508
395,255.4055426481072,304,0.13807558583895513,9.594710332155227,168812
396,58.58299075920908,237,0.13738520790976036,10.518647718429566,169049
397,297.8626862520417,358,0.13669828187021155,13.597884393930435,169407
398,186.3668027341398,275,0.13601479046086049,12.725796121358872,169682
399,264.17142963281935,428,0.1353347165085562,10.86623446881771,170110
400,87.61377624339521,1000,0.1346580429260134,8.066296211481095,171110
401,296.6346227027839,246,0.13398475271138335,12.356773564815521,171356
402,297.61777873896403,698,0.13331482894782642,12.10029816031456,172054
403,202.43170943458637,743,0.13264825480308728,8.930162702202797,172797
404,256.1463986602364,551,0.13198501352907185,13.880973274707793,173348
405,282.55297401147527,279,0.1313250884614265,13.598231093883514,173627
406,111.91993503017105,1000,0.13066846301911936,6.069184138178826,174627
407,-188.66986362400763,202,0.13001512070402377,15.113805730342865,174829
408,8.638946532931627,132,0.12936504510050365,5.469303013086319,174961
409,231.34109172042736,509,0.12871821987500112,15.549257106781006,175470
410,246.75214722518018,449,0.12807462877562611,13.800165546536446,175919
411,0.4050417821545409,188,0.12743425563174798,14.173892635107041,176107
412,235.10448857032517,308,0.12679708435358925,13.486069014072418,176415
413,217.9818938376235,593,0.1261630989318213,8.973164024353027,177008
414,271.72980324666065,210,0.1255322834371622,10.514371411204339,177218
415,109.82644707535282,1000,0.12490462201997637,6.862876067757607,178218
416,262.4231197999859,258,0.1242800989098765,8.76646518021822,178476
417,-12.259215042773064,130,0.12365869841532712,9.365367206335067,178606
418,232.63221143152896,240,0.12304040492325048,9.219713742733001,178846
419,-197.42205825981145,176,0.12242520289863423,8.998038083314896,179022
420,-308.77380071457935,265,0.12181307688414106,12.227664113640785,179287
421,229.46040426844462,341,0.12120401149972035,8.147018840312958,179628
422,250.53212917134326,351,0.12059799144222175,9.913952931165696,179979
423,269.35126527149373,227,0.11999500148501063,9.913314479589463,180206
424,-185.99270582104643,139,0.11939502647758558,11.248209164142608,180345
425,232.42438840392896,587,0.11879805134519765,15.380600347518921,180932
426,253.06123279734635,363,0.11820406108847166,15.917484334707261,181295
427,303.2300379018666,243,0.1176130407830293,18.665217256546022,181538
428,42.04766283963954,100,0.11702497557911415,14.239492275714873,181638
429,271.9695463562341,361,0.11643985070121858,25.12984658241272,181999
430,26.29457785422632,161,0.11585765144771248,9.318489562273026,182160
431,291.5979529980829,340,0.11527836319047392,16.810794752836227,182500
432,274.48356131309185,380,0.11470197137452155,15.624014282226563,182880
433,-49.38733628960925,208,0.11412846151764894,18.743277099132538,183088
434,277.20101126016993,385,0.1135578192100607,14.516625263690948,183473
435,281.80789857277585,395,0.11299003011401039,9.997331055402755,183868
436,271.5628005305531,322,0.11242507996344034,11.383610852360725,184190
437,242.74732347769918,589,0.11186295456362313,21.78256584882736,184779
438,-70.15669256035514,216,0.11130363979080501,11.686231867074966,184995
439,288.7748694662157,332,0.11074712159185099,9.108145809173584,185327
440,175.93456033131832,813,0.11019338598389174,14.103461126089096,186140
441,238.42516605655888,739,0.10964241905397228,16.12699700713158,186879
442,297.60039971606307,247,0.10909420695870241,11.160325932502747,187126
443,-183.9207426493114,300,0.1085487359239089,9.777980184555053,187426
444,263.7830137522223,350,0.10800599224428936,13.130603107213974,187776
445,-19.610386264647758,223,0.10746596228306791,12.633513269424439,187999
446,267.8880977113254,357,0.10692863247165257,14.16195993423462,188356
447,254.82193520375426,954,0.1063939893092943,10.815311205387115,189310
448,256.06699814062256,497,0.10586201936274783,18.335707395076753,189807
449,-174.9263563212236,424,0.10533270926593409,17.86212135076523,190231
450,-153.33117582922029,66,0.10480604571960442,14.955412966012954,190297
451,272.9138207721521,273,0.1042820154910064,13.093745633363724,190570
452,254.95204125884496,275,0.10376060541355137,11.207098482847213,190845
453,-162.36602406790996,296,0.1032418023864836,13.91177531182766,191141
454,234.4841346694673,287,0.10272559337455119,16.5260115391016,191428
455,-9.443943504192916,227,0.10221196540767843,12.767627811431884,191655
456,112.14401312226639,1000,0.10170090558064004,12.463181252479552,192655
457,-178.65283607136521,287,0.10119240105273684,10.132052221894265,192942
458,269.61356518720004,285,0.10068643904747315,22.103444200754165,193227
459,289.4763498333399,256,0.10018300685223579,13.992543912529946,193483
460,-49.408614556890114,64,0.0996820918179746,19.46087997496128,193547
461,-25.89267912243379,76,0.09918368135888474,11.43078744649887,193623
462,35.28418849984831,101,0.09868776295209031,14.263666059970856,193724
463,-25.613315297739177,111,0.09819432413732986,14.623218754529953,193835
464,-67.50440441268734,107,0.09770335251664321,17.102744462490083,193942
465,-87.29624088752496,328,0.09721483575406,12.443823425769805,194270
466,274.4935851328496,391,0.09672876157528969,28.542749491930007,194661
467,-261.0109589325199,123,0.09624511776741324,15.852335636615754,194784
468,269.30698080147965,586,0.09576389217857617,13.902290060520173,195370
469,257.3099394506006,464,0.09528507271768329,11.726159975528716,195834
470,258.68507349374624,247,0.09480864735409487,19.241194200515746,196081
471,172.25502237386445,522,0.0943346041173244,10.362927402257919,196603
472,191.83012773198809,269,0.09386293109673778,16.458648966550825,196872
473,-211.26127918031247,592,0.09339361644125409,13.667978873252869,197464
474,182.18108720057532,422,0.09292664835904782,21.727081977128982,197886
475,177.74582152966514,614,0.09246201511725258,10.851975013017654,198500
476,258.55439513927,220,0.09199970504166631,15.258338613510132,198720
477,227.06831636707807,300,0.09153970651645797,22.1983334004879,199020
478,221.31017009726807,455,0.09108200798387568,18.444762026071547,199475
479,132.919090365047,1000,0.0906265979439563,17.17071536064148,200475
