episode,reward,length,epsilon,mean_loss,steps
1,-108.7100870262492,72,0.98,21.17037123441696,72
2,-435.45745210534716,94,0.9603999999999999,85.95433963537216,166
3,-153.37372866571164,71,0.9411919999999999,81.37275670051575,237
4,-124.81610786518937,83,0.9223681599999999,80.48141454219818,320
5,19.271633273998106,86,0.9039207967999998,80.88290918111801,406
6,-80.82227804672567,74,0.8858423808639998,90.57039242744446,480
7,-107.76587900257138,82,0.8681255332467198,84.02477638244629,562
8,-103.39508312363081,77,0.8507630225817854,49.26659227609635,639
9,-200.66349069368525,164,0.8337477621301497,66.14060445308685,803
10,-101.9405611013382,77,0.8170728068875467,67.40126312971115,880
11,-119.32036976868915,102,0.8007313507497957,67.94964210987091,982
12,-86.06011593750092,99,0.7847167237347998,49.58154985904694,1081
13,-186.1001311871946,121,0.7690223892601038,56.370094058513644,1202
14,-94.65503629046343,103,0.7536419414749017,54.445276460647584,1305
15,-46.57355130377856,99,0.7385691026454037,33.331214921474455,1404
16,-247.68077112753497,87,0.7237977205924956,39.39247533798218,1491
17,-121.01098642341114,121,0.7093217661806457,29.05212609767914,1612
18,-190.93179729569525,111,0.6951353308570327,41.660013939142225,1723
19,-74.1283163180893,114,0.6812326242398921,30.990838130712508,1837
20,-64.68224683825495,66,0.6676079717550942,39.60167316675186,1903
21,-191.57259067820695,113,0.6542558123199923,35.878802037239076,2016
22,33.85340294442992,95,0.6411706960735924,31.489321327209474,2111
23,-163.9710940889372,122,0.6283472821521205,26.437855112552644,2233
24,-97.00241815183071,195,0.6157803365090782,39.71909172654152,2428
25,-42.83733253918585,126,0.6034647297788965,45.43433408737182,2554
26,-56.11873507593765,124,0.5913954351833186,47.42308483600616,2678
27,-98.98153824850266,146,0.5795675264796523,41.20658081531525,2824
28,-120.86870554300364,81,0.5679761759500592,37.464349279403685,2905
29,-58.88880912183746,74,0.5566166524310581,34.99784470558166,2979
30,-201.12618618535333,171,0.5454843193824369,29.829051179885866,3150
31,-100.64967575126892,101,0.5345746329947881,37.85057383298874,3251
32,-30.22454913439421,110,0.5238831403348924,28.939042689800264,3361
33,-90.85499717375438,137,0.5134054775281945,34.99760564088822,3498
34,-83.18653419114969,154,0.5031373679776306,21.945704975128173,3652
35,-94.79843363508746,140,0.493074620618078,33.95390879869461,3792
36,-226.0921228994951,145,0.48321312820571644,28.75579290151596,3937
37,-41.41379386239018,143,0.4735488656416021,42.902167448997496,4080
38,-66.46043990570212,258,0.46407788832877006,30.609444484710693,4338
39,-58.56793301500575,169,0.45479633056219465,17.042335213422774,4507
40,-279.34169453874335,138,0.44570040395095073,22.48646823644638,4645
41,-82.21697013260089,201,0.4367863958719317,27.210248280763626,4846
42,-69.38589347562804,115,0.42805066795449304,25.390585252046584,4961
43,-158.4697816681383,659,0.41948965459540316,19.494068316221238,5620
44,-104.73509352798818,846,0.4110998615034951,17.221618151664735,6466
45,-100.15186482782502,223,0.4028778642734252,19.908394186496736,6689
46,-228.0223405535882,432,0.39482030698795667,20.3311961376667,7121
47,66.60411582947637,187,0.38692390084819756,18.16462273359299,7308
48,-82.43665811318712,322,0.3791854228312336,14.246677091121674,7630
49,-26.46305188483771,196,0.37160171437460887,15.830635927915573,7826
50,-40.56917878484414,1000,0.3641696800871167,17.72942535638809,8826
51,-61.948769591708455,421,0.35688628648537435,18.63895301103592,9247
52,12.62100353052304,206,0.34974856075566685,21.45139760375023,9453
53,-71.77708403899658,380,0.3427535895405535,17.873650131225585,9833
54,-41.61245986354925,245,0.33589851774974244,16.8424314057827,10078
55,-208.6361622030895,612,0.3291805473947476,18.155863881111145,10690
56,-82.22124868920982,1000,0.32259693644685267,22.862273344993593,11690
57,6.0202401857450525,381,0.3161449977179156,18.28755071401596,12071
58,-116.40875215429662,1000,0.3098220977635573,27.462220849990846,13071
59,-102.57096378724196,1000,0.30362565580828615,23.85057038664818,14071
60,-50.19240678692778,1000,0.2975531426921204,21.84204815864563,15071
61,-90.03089895553546,1000,0.291602079838278,24.50740671634674,16071
62,-21.38497138299624,273,0.2857700382415124,20.345192341804506,16344
63,-124.81564114403176,714,0.2800546374766822,15.15175188422203,17058
64,-23.238092019362227,406,0.27445354472714856,21.265002393722533,17464
65,-66.5461452009956,1000,0.2689644738326056,19.937015793323518,18464
66,-19.726234608259624,1000,0.26358518435595346,19.20448677778244,19464
67,-21.583346585455075,1000,0.25831348066883436,19.68752520799637,20464
68,-25.86226765415742,525,0.2531472110554577,20.195740265846254,20989
69,-13.15553858522631,162,0.24808426683434853,20.074713550806045,21151
70,-211.60000252706226,1000,0.24312258149766156,25.261544790267944,22151
71,-189.8059867947254,86,0.2382601298677083,22.76382312297821,22237
72,4.098511508800044,252,0.23349492727035415,33.35561469554901,22489
73,-335.2883732107989,312,0.22882502872494706,25.808731615543365,22801
74,-17.874251578870332,1000,0.22424852815044813,34.47102938175201,23801
75,-256.67436287918474,60,0.21976355758743915,27.70345558166504,23861
76,-189.87792780730996,152,0.21536828643569036,16.306461131572725,24013
77,-249.33794492813323,928,0.21106092070697655,23.816017878055572,24941
78,23.772443075256938,1000,0.20683970229283702,44.92825842380524,25941
79,-10.078610016506431,296,0.20270290824698028,26.396488077640534,26237
80,0.8318029327565379,1000,0.19864885008204067,21.615954254865645,27237
81,-158.37227576304127,71,0.19467587308039985,26.700875424146652,27308
82,58.039464058717805,1000,0.19078235561879187,24.96482135772705,28308
83,6.0980695592251895,1000,0.18696670850641603,22.06191928744316,29308
84,14.365988491814475,1000,0.18322737433628772,32.78425587654114,30308
85,55.544563595568135,1000,0.17956282684956196,17.358528127670287,31308
86,-144.97420837248993,281,0.1759715703125707,19.715661286115647,31589
87,-426.1693840282502,368,0.1724521389063193,17.446565034389497,31957
88,-36.64811052713539,1000,0.16900309612819292,13.959536609649659,32957
89,24.74735326509461,1000,0.16562303420562907,20.18947990179062,33957
90,-79.33405432222575,352,0.16231057352151648,21.526043305397035,34309
91,-2.8907947971672456,143,0.15906436205108615,21.652211809158324,34452
92,-215.10263501987896,626,0.15588307481006441,21.825392261743545,35078
93,15.003518037431789,1000,0.15276541331386312,15.756891951560974,36078
94,-14.326673002563215,1000,0.14971010504758586,21.51208224773407,37078
95,107.5363289317742,1000,0.14671590294663414,16.96456579208374,38078
96,59.925547695103525,1000,0.14378158488770146,21.86194372653961,39078
97,147.25888115690614,1000,0.14090595318994742,24.82207325220108,40078
98,10.70476707978473,1000,0.13808783412614847,28.25997265815735,41078
99,-61.1337723552585,138,0.13532607744362551,15.252461558580398,41216
100,248.46147753846114,410,0.132619555894753,23.083758617639543,41626
101,33.66748470023838,1000,0.12996716477685794,22.971608815193175,42626
102,-0.043604971560526895,1000,0.12736782148132078,20.227652504444123,43626
103,247.4901824092263,560,0.12482046505169436,13.143803153038025,44186
104,-37.57791361398274,1000,0.12232405575066048,20.422375304698946,45186
105,-152.701738946965,184,0.11987757463564727,21.642063717842102,45370
106,212.7381415557262,419,0.11748002314293432,24.385595371723173,45789
107,31.601875332363047,1000,0.11513042268007563,14.407300157546997,46789
108,263.25117302089996,431,0.11282781422647412,15.6896819627285,47220
109,217.70924162390526,368,0.11057125794194463,16.95988220214844,47588
110,221.7277427472315,581,0.10835983278310574,17.203123812675475,48169
111,-24.522088378224087,1000,0.10619263612744362,18.461308143138886,49169
112,210.10698140572876,730,0.10406878340489474,10.300258369445801,49899
113,214.19472945902464,590,0.10198740773679685,13.716928827762604,50489
114,-40.019890792022636,1000,0.09994765958206091,18.818078401088716,51489
115,107.5047901858415,1000,0.0979487063904197,16.82217588186264,52489
116,229.081849344856,567,0.0959897322626113,12.053062982559204,53056
117,120.8440054424555,1000,0.09406993761735907,12.987715065479279,54056
118,269.1844759618033,494,0.0921885388650119,11.309933990240097,54550
119,219.9972397982625,544,0.09034476808771166,18.8766182410717,55094
120,-261.46342169843376,217,0.08853787272595742,9.645799351930618,55311
121,209.06962813125602,332,0.08676711527143827,13.867180707454681,55643
122,-223.618173207345,127,0.0850317729660095,16.83349856376648,55770
123,214.435897361843,528,0.08333113750668932,9.897813892364502,56298
124,267.39590320283696,728,0.08166451475655553,11.79730406522751,57026
125,90.46197286214445,1000,0.08003122446142442,18.38674986958504,58026
126,241.48350992168508,510,0.07843059997219594,20.42142382860184,58536
127,230.25445021890533,617,0.07686198797275202,12.096463369131088,59153
128,236.6018412427024,474,0.07532474821329699,9.950762561559678,59627
129,67.00993982723676,100,0.07381825324903105,9.714215960502624,59727
130,240.449887240262,259,0.07234188818405042,19.018753381967546,59986
131,188.74682616771366,862,0.07089505042036941,13.483668731451035,60848
132,20.566332212637036,1000,0.06947714941196202,9.883965716361999,61848
133,76.39070368446455,913,0.06808760642372277,9.998652437925339,62761
134,216.35629650827582,855,0.06672585429524831,20.85586067914963,63616
135,247.77853409909162,456,0.06539133720934334,15.889108743667602,64072
136,-266.39168952503474,238,0.06408351046515648,7.407806075811386,64310
137,245.54084481111704,561,0.06280184025585335,8.720041275024414,64871
138,200.2705180954149,362,0.061545803450736285,9.27166221499443,65233
139,238.9778276803326,563,0.060314887381721555,13.76158084154129,65796
140,195.8743478249271,987,0.05910858963408712,15.949723162651061,66783
141,-122.77732188410067,113,0.05792641784140538,15.38200850725174,66896
142,247.90274629299105,434,0.05676788948457727,13.837480707168579,67330
143,265.77080955532887,592,0.055632531694885724,11.446179951429366,67922
144,238.26803273071187,405,0.054519881060988006,13.96077173113823,68327
145,281.2954098166025,317,0.05342948343976824,12.643326553106307,68644
146,254.6863591903308,424,0.052360893770972874,9.28525495171547,69068
147,271.70987790369406,431,0.05131367589555342,12.781107975244522,69499
148,253.10314022507407,289,0.05028740237764235,13.39607748746872,69788
149,260.36733396937564,272,0.0492816543300895,19.26003531932831,70060
150,292.6696103514592,249,0.04829602124348771,8.808379902839661,70309
151,228.21663890735968,342,0.04733010081861796,10.81003676891327,70651
152,-283.06381913362463,225,0.0463834988022456,9.820475890636445,70876
153,247.72392435238766,385,0.04545582882620069,11.99430832028389,71261
154,250.1187262645734,369,0.04454671224967667,11.207125931978226,71630
155,267.1345072584463,333,0.043655778004683135,8.811592794656754,71963
156,59.48153696763425,1000,0.04278266244458947,11.861425874233246,72963
157,263.07640951385486,284,0.04192700919569768,10.12946528673172,73247
158,-133.86184494003837,243,0.04108846901178373,10.582808719873428,73490
159,222.1330970276436,320,0.04026669963154805,9.35269771695137,73810
160,256.7261995151735,437,0.03946136563891709,7.942559041380882,74247
161,256.08121321623196,547,0.03867213832613875,13.957499647140503,74794
162,228.78742515503126,324,0.037898695559615975,13.207675347328186,75118
163,254.3474721341481,349,0.03714072164842366,10.333533321619035,75467
164,290.645093665791,217,0.03639790721545518,11.686405119895936,75684
165,247.332480632871,363,0.035669949071146075,13.788551052212716,76047
166,231.4331289396228,381,0.034956550089723155,10.111511850357056,76428
167,241.77461350917704,215,0.03425741908792869,10.297155159711838,76643
168,290.60606826389926,297,0.03357227070617012,13.121028890609741,76940
169,221.1421371777834,303,0.032900825292046715,8.152484563589097,77243
170,269.300553560641,212,0.03224280878620578,8.789509629011155,77455
171,229.36870186574362,386,0.031597952610481664,8.610795621871949,77841
172,248.04219195958402,311,0.03096599355827203,7.646005002260208,78152
173,249.28326182604718,357,0.030346673687106588,9.535618324875832,78509
174,280.0519568492362,303,0.029739740213364455,5.4842344093322755,78812
175,240.05151571081657,270,0.029144945409097164,9.551980035305023,79082
176,288.37664503311487,313,0.02856204650091522,10.721231309175492,79395
177,242.35073729353113,451,0.027990805570896914,7.764874132871628,79846
178,237.86547568243498,570,0.027430989459478975,8.358690184354781,80416
179,243.9055028692599,333,0.026882369670289397,8.995906330347061,80749
180,157.94499884929365,367,0.026344722276883607,8.307133564949035,81116
181,241.73887604218658,297,0.025817827831345935,7.13150898873806,81413
182,267.3404271765569,387,0.025301471274719014,8.070700987577439,81800
183,251.07898216678726,244,0.024795441849224633,8.83491820216179,82044
184,231.33880349052154,301,0.02429953301224014,11.131101299524307,82345
185,243.63366877416456,248,0.02381354235199534,7.379863980412483,82593
186,274.19178506780327,237,0.02333727150495543,6.456585323810577,82830
187,260.62678982323087,728,0.02287052607485632,5.385288405418396,83558
188,289.83135077474856,332,0.022413115553359196,9.810957596302032,83890
189,246.47452924965563,289,0.021964853242292012,4.839869409799576,84179
190,243.83993362761862,222,0.02152555617744617,5.983010627031327,84401
191,228.90363180510766,461,0.021095045053897248,7.253760569691658,84862
192,-352.1966015506672,173,0.020673144152819303,6.055888414978981,85035
193,270.4952039803861,256,0.02025968126976292,9.981105306148528,85291
194,210.14900951378172,298,0.01985448764436766,6.582857230901718,85589
195,204.83751989234355,329,0.019457397891480308,6.015818066596985,85918
196,9.955251416834386,251,0.0190682499336507,5.465105693936348,86169
197,261.11320780326366,243,0.018686884934977686,5.896198027729988,86412
198,269.8870644958483,371,0.01831314723627813,5.693030526638031,86783
199,22.32711985032931,216,0.017946884291552567,17.85184109687805,86999
200,102.62075663800708,819,0.017587946605721515,6.545842667222023,87818
201,259.790841241313,214,0.017236187673607083,12.282760809659958,88032
202,291.10563445709346,277,0.016891463920134943,8.385423513054848,88309
203,237.45504476782057,301,0.016553634641732245,8.078995083570481,88610
204,281.12925405602334,276,0.0162225619488976,12.828431087732316,88886
205,207.8516919375879,236,0.015898110709919647,7.931190574765205,89122
206,-60.53923981971289,223,0.015580148495721254,7.1759649556875225,89345
207,260.43971113686507,179,0.015268545525806828,6.886204982995987,89524
208,255.3511085238597,501,0.014963174615290691,6.924480860233307,90025
209,262.1686513175108,224,0.014663911122984877,6.6319116175174715,90249
210,288.87586325829415,242,0.01437063290052518,12.688749473690986,90491
211,258.708189458959,377,0.014083220242514675,11.518949918746948,90868
212,284.13196417924775,310,0.013801555837664382,10.207562851905823,91178
213,261.36375933752106,226,0.013525524720911095,6.849830996990204,91404
214,292.4585840036091,349,0.013255014226492874,8.545931143760681,91753
215,300.00740389610746,211,0.012989913941963017,4.590703845620156,91964
216,299.7849505872472,227,0.012730115663123756,8.926503336429596,92191
217,240.6810387010855,253,0.012475513349861281,9.143023380041122,92444
218,-45.82620792200612,228,0.012226003082864055,10.360631424188615,92672
219,269.3002540645356,207,0.011981483021206774,9.899786735773086,92879
220,259.6774595104846,237,0.011741853360782638,5.461796202659607,93116
221,164.21752986358103,748,0.011507016293566985,5.992871634364128,93864
222,255.84757796640847,853,0.011276875967695645,8.958523975610733,94717
223,312.35543485387325,222,0.011051338448341731,8.965449352860452,94939
224,257.38215438687246,355,0.010830311679374895,5.831876680850983,95294
225,-44.28342053824335,169,0.010613705445787398,13.238207011222839,95463
226,252.4317311542306,330,0.01040143133687165,8.485819190740585,95793
227,239.86646168098036,221,0.010193402710134216,8.783171534538269,96014
228,-95.34102876445465,168,0.009989534655931531,7.443118859529495,96182
229,271.20799030334865,172,0.009989534655931531,15.983504256010056,96354
230,267.6904552921131,348,0.009989534655931531,6.110507145524025,96702
231,278.19892815607545,261,0.009989534655931531,14.020746809244155,96963
232,245.082706924763,224,0.009989534655931531,6.603759025335312,97187
233,269.6296300969511,191,0.009989534655931531,11.630186403393745,97378
234,261.67842420307034,342,0.009989534655931531,10.696078290343285,97720
235,243.39110728243872,208,0.009989534655931531,16.048768560886383,97928
236,271.89844915274205,341,0.009989534655931531,7.9212639462947845,98269
237,280.9413095459988,339,0.009989534655931531,8.252680790424346,98608
238,246.15058722811943,216,0.009989534655931531,8.630604741573334,98824
239,271.6427689244882,302,0.009989534655931531,13.272195049524306,99126
240,247.06606544881572,337,0.009989534655931531,8.68275773704052,99463
241,245.494718329827,346,0.009989534655931531,19.291212264299393,99809
242,241.8572110115703,243,0.009989534655931531,9.17448634326458,100052
243,262.6018024360677,331,0.009989534655931531,6.958441861867905,100383
244,255.1774556553361,196,0.009989534655931531,12.07274570465088,100579
245,271.3263570422692,281,0.009989534655931531,11.204574048519135,100860
246,257.0203986221704,209,0.009989534655931531,9.022091378569604,101069
247,260.2305405206285,421,0.009989534655931531,11.451668380498885,101490
248,300.11868668401695,307,0.009989534655931531,10.37259499669075,101797
249,246.25726669871386,371,0.009989534655931531,8.66644203543663,102168
250,239.30746211866634,276,0.009989534655931531,12.242158895134926,102444
251,284.34547602918997,266,0.009989534655931531,9.740086444616317,102710
252,257.5984013706567,381,0.009989534655931531,7.468164327144623,103091
253,253.72540462520158,247,0.009989534655931531,7.4154767340421675,103338
254,271.38563308468935,299,0.009989534655931531,11.097951743602753,103637
255,272.9872291038584,282,0.009989534655931531,10.708665766716003,103919
256,265.87350278214063,311,0.009989534655931531,6.201467002034187,104230
257,264.8840972853137,265,0.009989534655931531,5.029612836241722,104495
258,298.251538372008,259,0.009989534655931531,5.738248274326325,104754
259,267.2478497019912,292,0.009989534655931531,10.172716189622879,105046
260,229.9096353691084,286,0.009989534655931531,11.769885872006416,105332
261,290.9612395073672,237,0.009989534655931531,9.005883232355117,105569
262,253.3004805090865,214,0.009989534655931531,5.559095671176911,105783
263,260.5670094758242,269,0.009989534655931531,12.269722590446472,106052
264,257.13133176100655,195,0.009989534655931531,5.556474001407623,106247
265,261.3405238787888,281,0.009989534655931531,8.10267153084278,106528
266,239.30915067972603,230,0.009989534655931531,10.890100923776627,106758
267,246.67062181208198,246,0.009989534655931531,8.017157089114189,107004
268,230.80215066741343,426,0.009989534655931531,6.281739912629128,107430
269,259.889302044076,320,0.009989534655931531,10.729590032100678,107750
270,266.67045006194894,227,0.009989534655931531,9.418708581924438,107977
271,249.45926424412204,272,0.009989534655931531,10.185395529270172,108249
272,272.1214282932754,305,0.009989534655931531,7.0620042109489445,108554
273,278.69471019315426,328,0.009989534655931531,7.528540209531784,108882
274,242.4246601330829,265,0.009989534655931531,7.537363625764847,109147
275,264.85173149392006,260,0.009989534655931531,5.477435827255249,109407
276,269.7112402091396,302,0.009989534655931531,6.0677022796869275,109709
277,37.02864210274237,156,0.009989534655931531,8.65812029004097,109865
278,243.34326214915362,189,0.009989534655931531,5.927357450723648,110054
279,294.9338899444949,219,0.009989534655931531,8.723450514674187,110273
280,254.94244903550856,165,0.009989534655931531,7.104528982639312,110438
281,268.96309122849624,450,0.009989534655931531,16.956525020599365,110888
282,292.5576651147113,241,0.009989534655931531,6.37252135515213,111129
283,310.35110502047576,254,0.009989534655931531,6.175400767326355,111383
284,291.76589324041595,199,0.009989534655931531,4.416226926445961,111582
285,257.52678648098663,234,0.009989534655931531,13.11018227338791,111816
286,38.5348882751633,158,0.009989534655931531,15.911464819908142,111974
287,288.4994702085288,249,0.009989534655931531,5.833668205738068,112223
288,290.95458580430835,269,0.009989534655931531,10.096362207531929,112492
289,188.39089852435757,321,0.009989534655931531,5.194301409721374,112813
290,285.3963638736605,195,0.009989534655931531,8.352229377031327,113008
291,248.53638592424429,320,0.009989534655931531,4.884799941182137,113328
292,260.51925577572234,209,0.009989534655931531,4.841927944421768,113537
293,280.6886769963685,288,0.009989534655931531,10.49777837574482,113825
294,268.14105053978227,235,0.009989534655931531,5.987690070271492,114060
295,-119.27367178522107,705,0.009989534655931531,13.572509413957595,114765
296,233.83814710030694,268,0.009989534655931531,4.267051481604576,115033
297,-145.8549526617751,188,0.009989534655931531,17.39904639005661,115221
298,270.6205919343148,272,0.009989534655931531,8.174263149499893,115493
299,246.0720839067342,465,0.009989534655931531,10.120670011639595,115958
300,266.7325474386255,251,0.009989534655931531,8.85789272904396,116209
301,269.40219323214325,182,0.009989534655931531,6.069236592650413,116391
302,247.34474688229156,192,0.009989534655931531,6.347224239706993,116583
303,236.36562099010968,187,0.009989534655931531,6.700229566693306,116770
304,263.3415212334205,217,0.009989534655931531,5.3811327111721035,116987
305,271.88368084736874,278,0.009989534655931531,6.5732795244455335,117265
306,267.63599141464215,216,0.009989534655931531,13.517909821271896,117481
307,284.50579333228814,291,0.009989534655931531,5.44745330452919,117772
308,266.99233677261304,234,0.009989534655931531,9.78359575867653,118006
309,262.74763899858283,403,0.009989534655931531,7.771217932105064,118409
310,267.41443288985545,184,0.009989534655931531,5.629252042770386,118593
311,273.31229596339983,327,0.009989534655931531,12.219955541789531,118920
312,272.381953378806,228,0.009989534655931531,6.787840811610222,119148
313,282.77362495143257,228,0.009989534655931531,12.25924049973488,119376
314,279.9328298351476,216,0.009989534655931531,11.630105394721031,119592
315,256.0156833512618,218,0.009989534655931531,7.1418597060441975,119810
316,256.69063952924273,193,0.009989534655931531,6.875979200601578,120003
317,268.6589749560261,301,0.009989534655931531,7.90940495967865,120304
318,249.4703905395894,193,0.009989534655931531,11.136236721277237,120497
319,284.3729225585642,331,0.009989534655931531,4.733535532355308,120828
320,298.4589802994424,278,0.009989534655931531,5.204917289018631,121106
321,278.2940565948709,372,0.009989534655931531,13.101447144150734,121478
322,309.7051996140541,217,0.009989534655931531,8.063832588195801,121695
323,285.3599474477073,259,0.009989534655931531,8.45192698121071,121954
324,266.0645547967065,277,0.009989534655931531,14.259210189580918,122231
325,257.10285753837843,216,0.009989534655931531,8.578287652134895,122447
326,308.9301322023992,253,0.009989534655931531,15.012926201224326,122700
327,277.93277463240713,248,0.009989534655931531,4.036433410644531,122948
328,270.3092004549083,236,0.009989534655931531,5.292101027369499,123184
329,284.3063093607159,311,0.009989534655931531,7.378179879784584,123495
330,270.51580262042506,194,0.009989534655931531,5.61703028857708,123689
331,266.684582909905,212,0.009989534655931531,3.965436918735504,123901
332,301.81186856832494,303,0.009989534655931531,5.85856244623661,124204
333,273.8442231588836,213,0.009989534655931531,9.606566979885102,124417
334,280.90771050480464,240,0.009989534655931531,3.9417410886287687,124657
335,286.2709905217805,261,0.009989534655931531,10.332046823501587,124918
336,287.26143064801454,233,0.009989534655931531,11.135189477205277,125151
337,266.8005713041334,188,0.009989534655931531,4.558340101838112,125339
338,273.15455376577756,260,0.009989534655931531,4.694499616026878,125599
339,257.9485171279389,202,0.009989534655931531,3.9401208823919296,125801
340,289.9781115868932,261,0.009989534655931531,8.046365019679069,126062
341,251.92780834639217,201,0.009989534655931531,12.80260553598404,126263
342,267.46848181613507,307,0.009989534655931531,4.586115480065346,126570
343,283.8978035957342,208,0.009989534655931531,7.412230946421623,126778
344,271.3510293371703,234,0.009989534655931531,7.391543081402778,127012
345,269.83697344968846,224,0.009989534655931531,3.5265885901451113,127236
346,282.1178154282899,228,0.009989534655931531,4.908530284166336,127464
347,43.52338234759472,148,0.009989534655931531,12.058996455073357,127612
348,292.757912095525,283,0.009989534655931531,7.204507021307945,127895
349,35.30726069786547,136,0.009989534655931531,15.707035343050956,128031
350,273.9809111554917,205,0.009989534655931531,3.8915718710422516,128236
351,278.974837116863,217,0.009989534655931531,4.463408088684082,128453
352,273.97512171803714,238,0.009989534655931531,12.411964213252068,128691
353,268.42791206512663,242,0.009989534655931531,10.578851697444916,128933
354,258.595660766732,181,0.009989534655931531,3.8171343553066253,129114
355,297.45278279272475,335,0.009989534655931531,10.561514028906823,129449
356,279.786260878555,210,0.009989534655931531,5.928151018023491,129659
357,295.05192834006004,208,0.009989534655931531,15.956825934648514,129867
358,258.4602131607336,226,0.009989534655931531,17.304144545793534,130093
359,251.1218779062146,201,0.009989534655931531,8.971318029165268,130294
360,284.64729267922553,180,0.009989534655931531,10.67462308704853,130474
361,302.17772035377106,233,0.009989534655931531,3.9544706916809083,130707
362,297.5348830992635,460,0.009989534655931531,10.22333293735981,131167
363,293.42930130373054,219,0.009989534655931531,19.51811256289482,131386
364,17.974194910812017,166,0.009989534655931531,4.53062687754631,131552
365,283.0756035257039,239,0.009989534655931531,7.835057510733605,131791
366,268.75266991743285,311,0.009989534655931531,14.264039272069931,132102
367,261.9371779057628,378,0.009989534655931531,8.07335364818573,132480
368,251.42542468602568,203,0.009989534655931531,4.560124559402466,132683
369,273.5548806114451,277,0.009989534655931531,9.448045452833176,132960
370,277.9196819924188,204,0.009989534655931531,4.691028211712837,133164
371,273.32564292261014,399,0.009989534655931531,5.6857338887453075,133563
372,283.35840714911694,400,0.009989534655931531,11.323849252462388,133963
373,14.473540643054022,198,0.009989534655931531,9.200618445277215,134161
374,278.76843289416297,175,0.009989534655931531,18.85880908250809,134336
375,272.94315658895994,202,0.009989534655931531,8.503125341534615,134538
376,261.1093321968481,211,0.009989534655931531,5.088645756840706,134749
377,-124.44000710654376,363,0.009989534655931531,12.438822902441025,135112
378,232.4322341541452,191,0.009989534655931531,14.41280513525009,135303
379,251.10735972288367,269,0.009989534655931531,14.67095248579979,135572
380,247.130780291626,457,0.009989534655931531,10.523587052226066,136029
381,267.27929356834136,205,0.009989534655931531,11.417715630531312,136234
382,267.8137817692199,227,0.009989534655931531,10.87670933365822,136461
383,277.1173829452548,183,0.009989534655931531,18.027161741852762,136644
384,288.8893267959835,397,0.009989534655931531,7.799809913039208,137041
385,283.0164351748713,245,0.009989534655931531,6.218889495134354,137286
386,249.58820275277247,215,0.009989534655931531,5.019936529994011,137501
387,263.7475629508828,214,0.009989534655931531,22.77919078528881,137715
388,226.84694257586708,250,0.009989534655931531,11.074777200818062,137965
389,-3.8603303646770826,132,0.009989534655931531,9.316882116794586,138097
390,229.36573968735914,215,0.009989534655931531,12.978480783104896,138312
391,257.79208486162565,267,0.009989534655931531,20.57048086643219,138579
392,282.3162760967027,254,0.009989534655931531,5.933589937686921,138833
393,283.1744274054218,158,0.009989534655931531,11.144590842723847,138991
394,268.06900467343763,230,0.009989534655931531,5.264553315043449,139221
395,276.2920665190376,236,0.009989534655931531,5.745085971355438,139457
396,284.5397869438117,219,0.009989534655931531,12.17717227935791,139676
397,248.84626070683018,221,0.009989534655931531,9.770027247667313,139897
398,297.16068987311473,247,0.009989534655931531,10.42008078932762,140144
399,267.6457307278849,243,0.009989534655931531,6.738524278998375,140387
400,263.64256920494995,161,0.009989534655931531,6.993213368058204,140548
401,267.4677303265337,249,0.009989534655931531,10.058274229168893,140797
402,263.2756965859253,181,0.009989534655931531,14.967012547254562,140978
403,257.71323861244827,249,0.009989534655931531,8.005741230845452,141227
404,265.1726457745502,224,0.009989534655931531,7.020905106663704,141451
405,232.37929872657267,248,0.009989534655931531,12.009409019351006,141699
406,266.9537583039423,170,0.009989534655931531,9.70137774825096,141869
407,295.8399634912146,252,0.009989534655931531,6.733663994073868,142121
408,270.7636880653685,219,0.009989534655931531,14.487605547904968,142340
409,256.641355158359,195,0.009989534655931531,8.772118987441063,142535
410,-105.92755009038171,128,0.009989534655931531,8.179910778999329,142663
411,275.5303195699581,166,0.009989534655931531,9.217938213348388,142829
412,244.919178068384,181,0.009989534655931531,5.921880688071251,143010
413,286.47226634022064,266,0.009989534655931531,6.5482952207326885,143276
414,259.36853019589705,258,0.009989534655931531,13.277751488089562,143534
415,270.72563299751937,544,0.009989534655931531,21.29543650507927,144078
416,277.46199596050155,443,0.009989534655931531,9.941835027337074,144521
417,273.9464735697202,246,0.009989534655931531,4.5548130536079405,144767
418,257.3629259735685,234,0.009989534655931531,6.374696963429451,145001
419,266.36658489559613,304,0.009989534655931531,12.601999140381814,145305
420,263.31269313573944,253,0.009989534655931531,5.168630954027176,145558
421,286.8497188775604,275,0.009989534655931531,16.281875537633894,145833
422,-26.01664080300995,169,0.009989534655931531,8.401982227563858,146002
423,264.41519243573066,194,0.009989534655931531,9.937317698597909,146196
424,-33.0836343988252,173,0.009989534655931531,7.028737976551056,146369
425,8.811804789462826,149,0.009989534655931531,9.016458026170731,146518
426,35.182666324133436,177,0.009989534655931531,8.895919681787491,146695
427,280.3032104450243,198,0.009989534655931531,5.408406230807304,146893
428,291.3742012661611,222,0.009989534655931531,5.665198202729226,147115
429,290.0985046053474,228,0.009989534655931531,12.172689061760902,147343
430,247.6265694843987,200,0.009989534655931531,6.038637869954109,147543
431,275.17834512222265,263,0.009989534655931531,8.350394240617753,147806
432,156.51980142672687,400,0.009989534655931531,6.798392914533615,148206
433,271.1420601740456,239,0.009989534655931531,13.25213167309761,148445
434,26.79564807130643,129,0.009989534655931531,6.3152826410532,148574
435,268.35624609846013,261,0.009989534655931531,18.21113936781883,148835
436,257.6964406178526,201,0.009989534655931531,13.187488369941711,149036
437,269.36533119334075,233,0.009989534655931531,15.374689937829972,149269
438,275.84048450965633,198,0.009989534655931531,10.587870388627053,149467
439,271.7818623968209,240,0.009989534655931531,10.708121469020844,149707
440,275.5955632528784,610,0.009989534655931531,15.124424516558648,150317
441,241.8218625877421,275,0.009989534655931531,6.923334046602249,150592
442,270.0705276900843,225,0.009989534655931531,10.623036762475968,150817
443,246.4328463818397,209,0.009989534655931531,9.573634182214738,151026
444,297.21000899122225,233,0.009989534655931531,10.23120130598545,151259
445,281.7230971349116,326,0.009989534655931531,15.833765881061554,151585
446,285.0441966928163,203,0.009989534655931531,7.266737070679665,151788
447,261.4047672830379,228,0.009989534655931531,10.49276027083397,152016
448,258.2492962495555,255,0.009989534655931531,15.636469838619233,152271
449,28.688380771917394,234,0.009989534655931531,9.762479010224343,152505
450,303.76236092884375,253,0.009989534655931531,15.633732010126113,152758
451,276.9886012817657,238,0.009989534655931531,8.814191400408745,152996
452,280.5572460270082,224,0.009989534655931531,13.95297792494297,153220
453,264.2984017970961,513,0.009989534655931531,8.117162456512451,153733
454,261.8714874383095,200,0.009989534655931531,8.62351389348507,153933
455,296.28059808035806,339,0.009989534655931531,8.557104061245917,154272
456,279.40267433316467,205,0.009989534655931531,12.612951763868331,154477
457,292.2933569723979,316,0.009989534655931531,6.627644011378289,154793
458,234.3275821303618,251,0.009989534655931531,14.121643893122673,155044
459,233.77714327710493,314,0.009989534655931531,10.309796003699303,155358
460,254.11340534058283,253,0.009989534655931531,7.884050075411796,155611
461,254.83795039102188,291,0.009989534655931531,5.002998996973037,155902
462,261.0011256691462,184,0.009989534655931531,10.967466524839402,156086
463,272.06845407997747,254,0.009989534655931531,5.790158732533455,156340
464,257.97084801102005,253,0.009989534655931531,10.449725239872933,156593
465,268.8136006915705,564,0.009989534655931531,8.08758384346962,157157
466,256.1895099087883,293,0.009989534655931531,6.256871997714042,157450
467,277.2219316427834,320,0.009989534655931531,14.22666444659233,157770
468,55.89242194207117,219,0.009989534655931531,22.28331091105938,157989
469,264.41678931725045,337,0.009989534655931531,12.481129765510559,158326
470,258.71426349656406,195,0.009989534655931531,10.934244214892388,158521
471,265.2402498873603,170,0.009989534655931531,11.786421871185302,158691
472,-442.3804622680634,302,0.009989534655931531,13.754207445979118,158993
473,278.0019019329165,271,0.009989534655931531,15.559732185006142,159264
474,298.05842411752684,186,0.009989534655931531,5.738034634590149,159450
475,261.6060387278884,274,0.009989534655931531,10.199695847034455,159724
476,275.06555632889456,189,0.009989534655931531,5.310446587800979,159913
477,315.6079111355314,241,0.009989534655931531,19.592352961301803,160154
478,23.218582780542988,155,0.009989534655931531,14.16430155813694,160309
479,251.48044324910938,294,0.009989534655931531,9.999360376596451,160603
480,33.802017187476906,170,0.009989534655931531,8.244907116293907,160773
481,260.63668339889966,191,0.009989534655931531,5.073034452199936,160964
482,-12.75073903469773,350,0.009989534655931531,16.432590524554254,161314
483,259.89721149118753,261,0.009989534655931531,12.555547065734864,161575
484,294.03038165767146,214,0.009989534655931531,6.475350903272629,161789
485,302.9115021037875,230,0.009989534655931531,11.54889297425747,162019
486,286.96106130573276,187,0.009989534655931531,7.528355060219765,162206
487,290.4592113973831,238,0.009989534655931531,9.835785565972328,162444
488,268.78477481109576,502,0.009989534655931531,10.644938372969627,162946
489,74.86831341344984,165,0.009989534655931531,17.626886284947396,163111
490,236.31022261969187,265,0.009989534655931531,6.978540802597999,163376
491,294.8068144031349,179,0.009989534655931531,9.897257286906243,163555
492,289.0127417136481,263,0.009989534655931531,6.931172988414764,163818
493,280.8302768344944,324,0.009989534655931531,16.256774089336396,164142
494,264.8231052770319,262,0.009989534655931531,5.580397256016731,164404
495,280.0100277248971,229,0.009989534655931531,18.02928570151329,164633
496,37.745083894412886,225,0.009989534655931531,11.691687035560609,164858
497,24.02563570610282,114,0.009989534655931531,17.408821635246277,164972
498,257.5530454595529,195,0.009989534655931531,10.701438367962837,165167
499,257.48606469977267,189,0.009989534655931531,5.024395608305931,165356
500,280.45855659967424,228,0.009989534655931531,10.767043896913528,165584
501,17.05637580427276,114,0.009989534655931531,14.460792912244797,165698
502,300.78326840120565,194,0.009989534655931531,4.140511909723282,165892
503,289.0526327982897,242,0.009989534655931531,5.69346549987793,166134
504,266.55854067622334,249,0.009989534655931531,11.326959388256073,166383
505,-31.107568445888617,463,0.009989534655931531,5.266656589508057,166846
506,306.9430337711538,176,0.009989534655931531,9.94580601811409,167022
507,305.2722510328637,185,0.009989534655931531,15.119293243288993,167207
508,23.45281207614221,108,0.009989534655931531,14.842260068655014,167315
509,260.2854569663997,264,0.009989534655931531,9.152594903707504,167579
510,254.50755374978556,179,0.009989534655931531,16.238341141939163,167758
511,278.3229444288305,208,0.009989534655931531,14.860017230510712,167966
512,284.1261027970155,210,0.009989534655931531,15.161944509744645,168176
513,274.90492875909854,210,0.009989534655931531,10.299420112371445,168386
514,307.66138548589765,215,0.009989534655931531,19.24102994799614,168601
515,286.62257914762944,215,0.009989534655931531,16.734735746979712,168816
516,291.99643449867966,186,0.009989534655931531,8.781816188693046,169002
517,311.4223123633356,210,0.009989534655931531,20.96167494058609,169212
518,277.6693234134734,311,0.009989534655931531,9.338187667131423,169523
519,278.6214326794505,267,0.009989534655931531,15.661792134046555,169790
520,296.6836698406264,243,0.009989534655931531,11.019163652062415,170033
521,246.80503013742862,212,0.009989534655931531,6.693802455663681,170245
522,284.4902734580713,216,0.009989534655931531,11.65222304224968,170461
523,258.0905354958327,179,0.009989534655931531,13.73546672284603,170640
524,246.9530554071296,292,0.009989534655931531,7.118770748972893,170932
525,266.4246521906681,211,0.009989534655931531,25.35377304971218,171143
526,311.21134007913395,228,0.009989534655931531,19.764967694282532,171371
527,266.9720206329537,226,0.009989534655931531,28.966749622225763,171597
528,287.2234575670875,377,0.009989534655931531,6.097777697443962,171974
529,255.46025326101724,449,0.009989534655931531,13.877966309189796,172423
530,276.1490180707357,277,0.009989534655931531,6.985200298428535,172700
531,240.82528871859614,182,0.009989534655931531,15.235630048513412,172882
532,14.594548859538534,96,0.009989534655931531,6.715498923659324,172978
533,247.72824577969772,341,0.009989534655931531,13.836259063482284,173319
534,287.8407761693365,295,0.009989534655931531,13.50205503463745,173614
535,278.8889549853374,234,0.009989534655931531,8.393978834152222,173848
536,257.13152447333704,214,0.009989534655931531,14.053471930027008,174062
537,114.20599330395801,1000,0.009989534655931531,20.750469866991043,175062
538,-116.81746642402057,186,0.009989534655931531,24.80576073586941,175248
539,269.9595845665963,216,0.009989534655931531,16.540390166044237,175464
540,313.1443795970814,281,0.009989534655931531,12.652008516788483,175745
541,286.84475065412335,246,0.009989534655931531,7.053961780667305,175991
542,266.2379624811899,278,0.009989534655931531,13.469840508699416,176269
543,297.3501196799407,260,0.009989534655931531,10.914338164329529,176529
544,1.4644575071021961,96,0.009989534655931531,8.335739803910256,176625
545,286.28993268250747,242,0.009989534655931531,13.00092676103115,176867
546,285.5646105797649,179,0.009989534655931531,16.578340764045716,177046
547,3.7049043205223597,102,0.009989534655931531,20.307908227443694,177148
548,279.41265940277674,197,0.009989534655931531,13.709399851560592,177345
549,265.812889425763,485,0.009989534655931531,19.275773103237153,177830
550,293.15050062417737,167,0.009989534655931531,15.010070749521255,177997
551,307.7044801025843,428,0.009989534655931531,19.504692171812057,178425
552,275.833053634654,194,0.009989534655931531,8.792103106379509,178619
553,238.01187738097997,220,0.009989534655931531,11.107372170686721,178839
554,239.42515032336394,187,0.009989534655931531,8.620774712562561,179026
555,266.20455020469365,199,0.009989534655931531,10.808591779470444,179225
556,288.3188781255017,226,0.009989534655931531,14.601622722148896,179451
557,311.02797924685996,322,0.009989534655931531,12.479622406959534,179773
558,258.4040004147111,190,0.009989534655931531,10.146860682368278,179963
559,29.134025896606943,162,0.009989534655931531,10.049753318428992,180125
560,306.2592462001976,236,0.009989534655931531,6.413975738286972,180361
561,-3.5996204906223,102,0.009989534655931531,13.166794996261597,180463
562,270.7006702151515,226,0.009989534655931531,8.005146309137345,180689
563,279.33734686243884,202,0.009989534655931531,11.319367571473121,180891
564,44.37954950276978,104,0.009989534655931531,18.20542584180832,180995
565,259.96650765826814,223,0.009989534655931531,11.835363500714301,181218
566,36.177036968301735,145,0.009989534655931531,26.76220777153969,181363
567,281.4369742853584,196,0.009989534655931531,14.95739640235901,181559
568,303.91154418584017,235,0.009989534655931531,15.338677347898484,181794
569,263.0851687833949,192,0.009989534655931531,9.709609925746918,181986
570,255.12268846806097,312,0.009989534655931531,22.77780525326729,182298
571,272.1744055937964,208,0.009989534655931531,19.406451686620713,182506
572,84.25929353474235,1000,0.009989534655931531,15.74914559006691,183506
573,281.18647986323566,259,0.009989534655931531,16.691569422483443,183765
574,17.1123955745136,137,0.009989534655931531,15.659546624422074,183902
575,316.98154350193204,239,0.009989534655931531,13.080876387357712,184141
576,278.9898355995963,227,0.009989534655931531,25.51867310523987,184368
577,292.2339037049167,248,0.009989534655931531,11.991605560779572,184616
578,262.4187235645912,210,0.009989534655931531,9.453484536409379,184826
579,-269.0640234024588,316,0.009989534655931531,9.964863325357436,185142
580,-35.4726013777626,104,0.009989534655931531,34.108471264839174,185246
581,-207.8995648644881,318,0.009989534655931531,24.97102087020874,185564
582,229.40936228583573,211,0.009989534655931531,16.353798543214797,185775
583,302.3128411809786,277,0.009989534655931531,28.656941940784453,186052
584,240.27994054171668,304,0.009989534655931531,13.590053861141206,186356
585,167.3342917289182,962,0.009989534655931531,20.677260345220567,187318
586,274.7929375583699,275,0.009989534655931531,16.55328799366951,187593
587,283.622378878448,265,0.009989534655931531,28.732598222494126,187858
588,6.252897275162994,126,0.009989534655931531,29.51864230275154,187984
589,-211.25661873152313,159,0.009989534655931531,14.13963649868965,188143
590,38.52531037160148,93,0.009989534655931531,16.40117565870285,188236
591,246.6753234057681,456,0.009989534655931531,21.432560114860536,188692
592,275.1276184910993,232,0.009989534655931531,12.896639008522033,188924
593,292.131702047471,217,0.009989534655931531,30.943389954566957,189141
594,287.3834387462325,280,0.009989534655931531,22.819342868328093,189421
595,238.18499889965037,304,0.009989534655931531,28.026701875925063,189725
596,234.02848245319367,501,0.009989534655931531,26.17563427209854,190226
597,293.0151496901285,314,0.009989534655931531,25.715223960876465,190540
598,-18.2090372740451,109,0.009989534655931531,18.32575658082962,190649
599,261.6220657653586,304,0.009989534655931531,24.043351312875746,190953
600,173.5639667312857,455,0.009989534655931531,18.9676249730587,191408
601,308.5661856932814,306,0.009989534655931531,11.13419163942337,191714
602,299.5385930643846,326,0.009989534655931531,22.729881217479704,192040
603,258.1047446710576,215,0.009989534655931531,23.228686991930008,192255
604,296.2583521295612,279,0.009989534655931531,36.40520930290222,192534
605,145.24100685471402,268,0.009989534655931531,23.52087301492691,192802
606,237.39526559227866,251,0.009989534655931531,10.98962607383728,193053
607,286.0341940657007,274,0.009989534655931531,11.230283505916596,193327
608,306.6289051786877,253,0.009989534655931531,17.71452014327049,193580
609,303.8674478557741,368,0.009989534655931531,15.80724091410637,193948
610,289.91308534916175,242,0.009989534655931531,10.838484598398209,194190
611,281.8632282623517,226,0.009989534655931531,15.853606252670287,194416
612,291.8237406900146,195,0.009989534655931531,5.707889574766159,194611
613,287.28423623259766,288,0.009989534655931531,18.47494187951088,194899
614,256.45506241470787,281,0.009989534655931531,14.163875021934508,195180
615,293.2730343856439,238,0.009989534655931531,15.398083317279816,195418
616,287.33852158766456,475,0.009989534655931531,15.801571097373962,195893
617,262.95924372259833,327,0.009989534655931531,13.356278674602509,196220
618,168.92047117604866,547,0.009989534655931531,13.903325820565223,196767
619,255.37770298100784,215,0.009989534655931531,15.759987310171127,196982
620,281.3126469609373,250,0.009989534655931531,13.387385841608047,197232
621,268.6206942383359,258,0.009989534655931531,21.3718241751194,197490
622,265.0994725205488,240,0.009989534655931531,10.945795199871064,197730
623,-31.574873485461524,173,0.009989534655931531,32.30879177927971,197903
624,239.84502373646237,320,0.009989534655931531,14.222749744653703,198223
625,277.26745284092794,215,0.009989534655931531,20.750520790815354,198438
626,274.80992952201007,246,0.009989534655931531,18.162584874629975,198684
627,250.48370604567083,316,0.009989534655931531,13.654312353134156,199000
628,299.3387012932022,208,0.009989534655931531,14.926591638326645,199208
629,251.9550640626054,235,0.009989534655931531,16.065647795796394,199443
630,283.6567929346314,304,0.009989534655931531,17.889261778593063,199747
631,240.10383237924106,360,0.009989534655931531,13.702459367513656,200107
