episode,reward,length,epsilon,mean_loss,steps
1,48.3775849430225,1000,0.995,8.877462356090545,1000
2,-112.23835281204539,71,0.990025,7.974787321090698,1071
3,-95.7145724274344,106,0.985074875,41.00602208852768,1177
4,-72.9482242841272,71,0.9801495006250001,52.59586400032043,1248
5,-226.0977983485239,122,0.9752487531218751,42.505546207427976,1370
6,-253.9757102087006,85,0.9703725093562657,71.2750794172287,1455
7,-119.92489761846737,95,0.9655206468094844,85.84417645692825,1550
8,-205.0951442870131,109,0.960693043575437,86.54122088432312,1659
9,-246.6330389502144,101,0.9558895783575597,71.1803663444519,1760
10,-127.08937909986467,80,0.9511101304657719,40.10119211196899,1840
11,-113.89062259664335,78,0.946354579813443,33.76926255226135,1918
12,-92.98794437738867,88,0.9416228069143757,36.80526321411133,2006
13,-95.73179157738893,119,0.9369146928798039,42.126720509529115,2125
14,-120.22066019728537,125,0.9322301194154049,32.487133445739744,2250
15,-68.14645655766893,67,0.9275689688183278,34.7139394402504,2317
16,-158.06857708027954,117,0.9229311239742362,48.48342426538468,2434
17,-190.07946950163085,73,0.918316468354365,43.02861070394516,2507
18,-97.63586775837202,65,0.9137248860125932,77.47988714694976,2572
19,-155.32215189105492,96,0.9091562615825302,52.02739819765091,2668
20,-226.0567001428958,124,0.9046104802746175,55.72218296051025,2792
21,-131.18367906924232,136,0.9000874278732445,101.81334735870361,2928
22,-78.73456818041709,78,0.8955869907338783,78.36904072284699,3006
23,-66.41968167273146,69,0.8911090557802088,117.9809631228447,3075
24,-314.795675086143,99,0.8866535105013078,87.75103830814362,3174
25,-139.24615057475893,99,0.8822202429488013,81.3598701620102,3273
26,-104.6736150040961,83,0.8778091417340573,83.65176865100861,3356
27,-87.44414976058579,123,0.8734200960253871,86.72450755834579,3479
28,-54.73676213987288,72,0.8690529955452602,68.35264807701111,3551
29,-108.4995706809357,96,0.8647077305675338,60.55948194980621,3647
30,-135.94544365255032,104,0.8603841919146962,70.23318096637726,3751
31,-79.81321984681752,91,0.8560822709551227,59.90912811279297,3842
32,-152.89192966581794,101,0.851801859600347,60.03316687107086,3943
33,-177.68497164672752,70,0.8475428503023453,64.53773357391357,4013
34,-353.3455189883874,114,0.8433051360508336,67.22664500951767,4127
35,-150.53292391467227,87,0.8390886103705794,66.07653446674347,4214
36,-113.98838665943288,85,0.8348931673187264,43.83640923023224,4299
37,-110.90654837843763,63,0.8307187014821328,40.271995749473575,4362
38,-111.86667736915132,67,0.8265651079747222,86.3212136220932,4429
39,-133.07307130039572,69,0.8224322824348486,72.17384546279908,4498
40,-138.4382618067262,128,0.8183201210226743,59.04099756956101,4626
41,-110.27836923675093,96,0.8142285204175609,54.04215507745743,4722
42,-40.421919811456505,74,0.810157377815473,82.64227445602417,4796
43,-225.1856079694358,118,0.8061065909263957,73.85311850786209,4914
44,-97.34475968007708,65,0.8020760579717637,117.2141943359375,4979
45,-124.75303622578627,108,0.798065677681905,82.66634825706483,5087
46,-140.82053583195687,80,0.7940753492934954,89.7820192861557,5167
47,-128.76530075782304,104,0.7901049725470279,105.31630500078201,5271
48,-165.2452640243331,71,0.7861544476842928,81.63858657121658,5342
49,-105.73431688832451,89,0.7822236754458713,84.44060891151429,5431
50,-205.33494264589498,127,0.778312557068642,89.30429984807968,5558
51,-311.55179132972387,88,0.7744209942832988,83.53125370740891,5646
52,-157.17344493070863,100,0.7705488893118823,97.5194444656372,5746
53,-227.02774435473748,110,0.7666961448653229,87.69548837661743,5856
54,-246.45116063970522,97,0.7628626641409962,101.2728453350067,5953
55,-165.3700547159165,95,0.7590483508202912,113.0814160823822,6048
56,-290.8113195570635,72,0.7552531090661897,121.81635422706604,6120
57,-96.26673144046067,75,0.7514768435208588,142.71852580070495,6195
58,-398.92429720875475,81,0.7477194593032545,158.9800228214264,6276
59,-143.7776017108889,89,0.7439808620067382,107.11601589679718,6365
60,-248.45802115905278,114,0.7402609576967045,78.44187545776367,6479
61,-173.3224655390021,111,0.736559652908221,112.2923180770874,6590
62,-74.48021024878639,66,0.7328768546436799,111.52840588569642,6656
63,-179.7902181490096,117,0.7292124703704616,118.52036381244659,6773
64,-291.030926783664,75,0.7255664080186093,97.89541015148163,6848
65,-277.2573341122717,107,0.7219385759785162,77.04358917713165,6955
66,-348.43687318235726,84,0.7183288830986236,135.6147301864624,7039
67,-98.9689989814371,109,0.7147372386831305,171.8862714576721,7148
68,-79.0745503333736,70,0.7111635524897149,66.53120457649231,7218
69,-206.54362466019802,113,0.7076077347272662,127.32083542346955,7331
70,-57.07483368374871,74,0.7040696960536299,60.34279706478119,7405
71,-321.22813266422077,106,0.7005493475733617,49.417504279613496,7511
72,-63.518297301590295,106,0.697046600835495,69.63614706516266,7617
73,-191.87377509730663,82,0.6935613678313175,48.34701328039169,7699
74,-320.47156254425215,65,0.6900935609921609,56.014805002212526,7764
75,-203.79179334138573,83,0.6866430931872001,87.60542313098908,7847
76,-208.03814270336022,106,0.6832098777212641,76.4685465669632,7953
77,-60.488788460525065,86,0.6797938283326578,51.80231267690659,8039
78,-122.21852165364935,99,0.6763948591909945,38.82826862096786,8138
79,-169.09410791068595,82,0.6730128848950395,75.91784961700439,8220
80,-306.9042122389242,95,0.6696478204705644,85.81912048339844,8315
81,-249.52772832389803,110,0.6662995813682115,47.62405998468399,8425
82,-212.20699461443786,97,0.6629680834613705,67.98611230611802,8522
83,-290.3998999111913,91,0.6596532430440636,38.05996401786804,8613
84,-52.935927724856626,76,0.6563549768288433,88.13479618310929,8689
85,-241.57426900210763,109,0.653073201944699,46.59981132507324,8798
86,-78.92345519720479,67,0.6498078359349755,38.4493445110321,8865
87,-247.84434612688094,71,0.6465587967553006,52.688920605182645,8936
88,-128.87923752014092,141,0.6433260027715241,69.23264213800431,9077
89,-185.60128146370528,127,0.6401093727576664,40.85955236673355,9204
90,-166.15312587012602,126,0.6369088258938781,53.16690630912781,9330
91,-161.17867078028476,101,0.6337242817644086,47.2500700545311,9431
92,-163.01180094247167,115,0.6305556603555866,57.05110061168671,9546
93,-152.15487314332225,95,0.6274028820538087,43.37629386901855,9641
94,-121.74510075385871,151,0.6242658676435396,37.96076138973236,9792
95,-215.0139469720661,127,0.6211445383053219,30.02987505197525,9919
96,-68.85320538479323,137,0.6180388156137953,49.76900477409363,10056
97,-22.25031178754473,118,0.6149486215357263,48.87172422647476,10174
98,-335.89157900458343,114,0.6118738784280476,74.39054999828339,10288
99,-101.06157325518141,114,0.6088145090359074,41.454628090858456,10402
100,-145.2408481841936,115,0.6057704364907278,48.51492539167404,10517
101,-303.4190962566493,84,0.6027415843082742,47.93765961408615,10601
102,-76.83490679472314,104,0.5997278763867329,77.16395896434784,10705
103,-81.95667759833252,206,0.5967292370047992,48.91481744050979,10911
104,-37.63888523995588,148,0.5937455908197752,43.46443861484528,11059
105,-82.63468137252113,112,0.5907768628656763,31.895143585205076,11171
106,-85.19528196650754,98,0.5878229785513479,31.289676814079286,11269
107,-162.14938411707482,235,0.5848838636585911,44.61775327563286,11504
108,-208.8232532810075,233,0.5819594443402982,47.85755475997925,11737
109,-210.84426820335037,195,0.5790496471185967,41.932519581317905,11932
110,-42.453436017337566,192,0.5761543988830038,35.518134751319884,12124
111,-14.852436474271073,144,0.5732736268885887,33.498050944805144,12268
112,-27.11696798209229,112,0.5704072587541458,47.919386291503905,12380
113,-24.256380782873848,156,0.567555222460375,44.967727396488186,12536
114,-171.95270129709837,254,0.5647174463480732,41.61476088285446,12790
115,-47.951098182796805,153,0.5618938591163328,37.091466040611266,12943
116,-20.00422339575411,217,0.5590843898207511,33.45942288398743,13160
117,-315.37992011731933,183,0.5562889678716474,37.612736706733706,13343
118,-88.6065283126361,135,0.5535075230322891,51.25426855802536,13478
119,-13.224634263896093,139,0.5507399854171277,49.92916706085205,13617
120,-118.30068794304046,173,0.547986285490042,34.5842035317421,13790
121,-87.16737789439246,138,0.5452463540625918,36.06444810152054,13928
122,-294.36973181521046,157,0.5425201222922789,39.47541202545166,14085
123,-120.68542910343109,277,0.5398075216808175,40.08129860162735,14362
124,-69.20540963491598,178,0.5371084840724134,42.78567192554474,14540
125,-40.9245386329203,142,0.5344229416520513,56.27415861129761,14682
126,-123.52390551446459,154,0.531750826943791,41.442146029472354,14836
127,-54.05064615890515,109,0.5290920728090721,57.18699518442154,14945
128,-76.58002476416672,163,0.5264466124450268,39.430647382736204,15108
129,-92.27052321744146,143,0.5238143793828016,49.91707995414734,15251
130,-69.92694013099384,134,0.5211953074858876,43.400687422752384,15385
131,-111.42520047406285,142,0.5185893309484582,34.177819211483005,15527
132,-240.06420803527323,253,0.5159963842937159,42.95112627506256,15780
133,-89.45619237789114,116,0.5134164023722473,49.96739049434662,15896
134,-11.290705273748642,175,0.510849320360386,46.97161979198456,16071
135,-194.52330546673113,271,0.5082950737585841,55.67740699529648,16342
136,-38.7058482043427,134,0.5057535983897912,38.38562285900116,16476
137,-196.3884505120693,144,0.5032248303978422,53.32179186105728,16620
138,-110.40422225587193,317,0.500708706245853,71.33197605609894,16937
139,-114.98134138039588,107,0.4982051627146237,45.25533411979675,17044
140,-126.35132060953649,441,0.49571413690105054,91.27298824310303,17485
141,-109.6912457490128,173,0.4932355662165453,50.347813336849214,17658
142,-77.51152870830178,625,0.4907693883854626,31.46936833381653,18283
143,-41.358916417160785,130,0.4883155414435353,57.6620939540863,18413
144,-97.22792072590994,112,0.4858739637363176,33.9259036898613,18525
145,-100.5191605160672,354,0.483444593917636,34.40504647731781,18879
146,-14.309906681152142,187,0.4810273709480478,59.774660058021546,19066
147,-83.4953764891772,200,0.47862223409330756,30.17108330488205,19266
148,-18.317762496799048,166,0.47622912292284103,71.67326018333435,19432
149,-0.44333275988184084,178,0.4738479773082268,37.124158072471616,19610
150,-74.28165695729271,163,0.47147873742168567,38.596037933826445,19773
151,-137.62570303808502,644,0.46912134373457726,31.274838256835938,20417
152,-4.56635105444235,139,0.46677573701590436,50.16714615106583,20556
153,9.719710099503104,242,0.46444185833082485,53.51138135671616,20798
154,6.291210811402763,230,0.46211964903917074,59.868179149627686,21028
155,-115.37413172340355,682,0.4598090507939749,39.935271692276004,21710
156,-38.28802845208564,103,0.457510005540005,41.968969225883484,21813
157,-222.34557227370647,668,0.45522245551230495,68.98069147586823,22481
158,2.7591544938725576,370,0.4529463432347434,62.10957347869873,22851
159,-149.10562560743654,841,0.4506816115185697,40.147230668067934,23692
160,-6.606894930437818,192,0.4484282034609769,46.14416350364685,23884
161,-41.76829757514754,305,0.446186062443672,41.263549420833584,24189
162,-71.10115514617269,424,0.4439551321314536,58.73285512685776,24613
163,-124.77417288085816,1000,0.4417353564707963,81.14213180065155,25613
164,20.636489590335188,106,0.43952667968844233,75.50718049049378,25719
165,-29.223864593527182,89,0.43732904629000013,43.53509663105011,25808
166,-53.0436694151728,1000,0.4351424010585501,55.955943276882174,26808
167,-83.8884131570601,101,0.43296668905325736,56.31563170909882,26909
168,-33.00276865766013,93,0.43080185560799106,73.37013836860656,27002
169,-60.4060249437686,235,0.4286478463299511,91.77084949016572,27237
170,-235.06329070980433,241,0.42650460709830135,44.03671011924744,27478
171,14.12219263055701,138,0.42437208406280985,43.88310179710388,27616
172,-58.67324310666477,1000,0.4222502236424958,88.73889867305756,28616
173,-184.59660161585862,165,0.42013897252428334,53.12281460523605,28781
174,-256.8053175031433,982,0.4180382776616619,52.60382279872894,29763
175,0.5806987757375879,143,0.4159480862733536,70.10392266750335,29906
176,-85.86769864249817,1000,0.41386834584198684,70.75502987861633,30906
177,-106.25057652682304,175,0.4117990041127769,49.27137094497681,31081
178,-19.164191980058526,1000,0.40974000909221303,54.31578316211701,32081
179,-108.78744520515306,139,0.40769130904675194,62.406060347557066,32220
180,-115.31515525968385,1000,0.40565285250151817,49.112608571052554,33220
181,-393.194981329804,701,0.4036245882390106,55.19306043624878,33921
182,-87.56403316292953,189,0.4016064652978155,69.81468058109283,34110
183,-71.34133728180241,149,0.3995984329713264,62.86919104099274,34259
184,-15.35542622667654,1000,0.3976004408064698,67.65878505229949,35259
185,-102.51382295835069,103,0.39561243860243744,51.40152414321899,35362
186,-36.80276435772031,1000,0.3936343764094253,63.19871917724609,36362
187,73.82325671629332,1000,0.39166620452737816,44.12838095188141,37362
188,25.78251195008255,102,0.3897078735047413,51.16178579807281,37464
189,0.6140688606770794,152,0.3877593341372176,62.51684996604919,37616
190,-100.96071510573658,128,0.3858205374665315,40.28702998638153,37744
191,-35.27291070863747,126,0.38389143477919885,62.75396118640899,37870
192,41.4090854005706,1000,0.3819719776053028,74.27804810523986,38870
193,24.601836374941406,1000,0.3800621177172763,54.142534761428834,39870
194,-25.624734007617832,1000,0.37816180712868996,68.27914132595062,40870
195,101.4371486648566,1000,0.37627099809304654,46.759080238342285,41870
196,-37.799377597886235,118,0.3743896431025813,66.87176294326783,41988
197,-116.07537127452439,154,0.37251769488706843,50.56465882778168,42142
198,-9.31282394361493,109,0.3706551064126331,66.7930964756012,42251
199,93.77351128532129,1000,0.36880183088056995,55.662884826660154,43251
200,-18.005278014857836,320,0.3669578217261671,50.848575463294985,43571
201,106.57243334776572,1000,0.36512303261753626,60.18282663822174,44571
202,-3.006442524956796,129,0.3632974174544486,45.79174831390381,44700
203,67.18356295845211,1000,0.3614809303671764,36.026711797714235,45700
204,95.51154433970821,1000,0.3596735257153405,45.086330013275145,46700
205,-190.97961961669296,349,0.3578751580867638,50.76359285354614,47049
206,18.46347436192181,1000,0.35608578229633,46.18866561412811,48049
207,66.8026442161895,1000,0.3543053533848483,37.058563876152036,49049
208,77.71462483382764,1000,0.35253382661792404,27.659575295448303,50049
209,-186.44453603300025,275,0.3507711574848344,44.48685796260834,50324
210,39.366928506879376,1000,0.34901730169741024,31.721290724277495,51324
211,49.40146452934792,1000,0.3472722151889232,50.48020372867584,52324
212,108.16677808414774,1000,0.3455358541129786,51.589545230865475,53324
213,43.58602842680112,1000,0.3438081748424137,47.59294816970825,54324
214,-211.0973763877811,274,0.3420891339682016,35.49170742034912,54598
215,113.99480078568088,1000,0.3403786882983606,51.88711871147156,55598
216,-85.00798961523412,199,0.3386767948568688,37.6573912525177,55797
217,87.92278714314895,1000,0.33698341088258443,38.07720498561859,56797
218,-77.82545447785157,156,0.3352984938281715,56.553700680732724,56953
219,-207.09079906266425,379,0.33362200135903064,39.82147162914276,57332
220,-168.90291981435365,422,0.33195389135223546,38.6747274184227,57754
221,-221.94020518465436,477,0.3302941218954743,42.75162231206894,58231
222,-3.057901826497911,146,0.32864265128599696,56.89155459403992,58377
223,63.96121211271344,1000,0.326999438029567,41.53386874198914,59377
224,19.653346171886227,212,0.3253644408394192,30.547640199661256,59589
225,-201.2544644666501,330,0.3237376186352221,46.174526467323304,59919
226,-76.3713831521047,1000,0.322118930542046,45.405731220245364,60919
227,-180.07829368155004,238,0.32050833588933575,30.385161015987396,61157
228,-147.88515331410719,888,0.31890579420988907,34.51311404943466,62045
229,10.892305748784423,1000,0.3173112652388396,44.57869610548019,63045
230,-42.81025563026695,199,0.3157247089126454,47.95506306171417,63244
231,89.21374761545125,1000,0.3141460853680822,36.869171233177184,64244
232,57.1050068007611,1000,0.3125753549412418,61.17689952850342,65244
233,55.295529286566094,1000,0.31101247816653554,33.097704131603244,66244
234,12.533260725687818,1000,0.30945741577570285,49.01257729053497,67244
235,154.78195516956347,1000,0.3079101286968243,43.67177593231201,68244
236,84.55155141611128,1000,0.3063705780533402,48.88745108127594,69244
237,144.21150522349512,1000,0.30483872516307353,46.26431364059448,70244
238,-281.6220347601918,783,0.3033145315372582,45.53040438890457,71027
239,108.81419520788349,1000,0.3017979588795719,41.177631483078,72027
240,128.18339531172606,1000,0.30028896908517405,22.668589210510255,73027
241,161.8610400556106,950,0.2987875242397482,49.384801664352416,73977
242,-150.63176391744167,346,0.29729358661854943,45.086725478172305,74323
243,-168.04983655367818,671,0.29580711868545667,53.90179930210113,74994
244,-49.84037343191591,114,0.2943280830920294,27.817119772434236,75108
245,-151.72344436091785,310,0.29285644267656924,24.69281163930893,75418
246,72.54988214404727,1000,0.2913921604631864,31.34027566432953,76418
247,-221.21946666103565,438,0.28993519966087045,41.1783830165863,76856
248,96.3472105361595,1000,0.2884855236625661,23.474499022960664,77856
249,139.83957453351778,1000,0.28704309604425327,39.05921260356903,78856
250,-61.83427322871083,131,0.285607880564032,36.47457662343979,78987
251,-245.91786302837835,193,0.28417984116121187,37.63589480876922,79180
252,-171.97449557584724,176,0.2827589419554058,33.74999319791794,79356
253,82.22450330017095,1000,0.28134514724562876,44.31906946182251,80356
254,-300.5154957732364,561,0.2799384215094006,28.756556639671327,80917
255,-94.51917429228016,137,0.27853872940185365,36.67018576145172,81054
256,106.77975776178724,1000,0.27714603575484437,35.764812922477724,82054
257,73.3537084306415,1000,0.2757603055760701,25.153566167354583,83054
258,-189.34518507805294,851,0.2743815040481898,39.5999488067627,83905
259,93.39459942438847,1000,0.2730095965279488,39.58514163017273,84905
260,96.39588417994447,1000,0.27164454854530906,31.56538007736206,85905
261,-146.28651276271916,893,0.2702863258025825,52.67992664575577,86798
262,71.70501704203512,1000,0.2689348941735696,26.125602116584776,87798
263,63.55169092189669,1000,0.26759021970270175,40.38256119251251,88798
264,78.93727573467123,1000,0.2662522686041882,26.44953067779541,89798
265,101.07696943725516,1000,0.2649210072611673,44.77655519008636,90798
266,79.07411008150271,1000,0.26359640222486147,44.59436670780182,91798
267,18.246374035168973,1000,0.26227842021373715,29.904413056373595,92798
268,50.12292375521226,1000,0.2609670281126685,26.379620683193206,93798
269,-94.42339110349424,470,0.25966219297210513,21.982064890861512,94268
270,118.98935520821405,1000,0.2583638820072446,29.076393468379976,95268
271,59.91512857741338,1000,0.2570720625972084,27.10329285144806,96268
272,140.5023225951702,1000,0.25578670228422234,21.53237675666809,97268
273,-229.43095106567523,785,0.25450776877280124,20.23542442083359,98053
274,160.28492068348768,1000,0.2532352299289372,23.33301999568939,99053
275,98.06062151103335,1000,0.2519690537792925,30.603573055267333,100053
276,141.7982575682308,1000,0.2507092085103961,24.418672811985015,101053
277,148.46771952797437,1000,0.2494556624678441,19.388929929733276,102053
278,109.17796050171077,1000,0.24820838415550486,26.00767011642456,103053
279,125.73042157769062,1000,0.24696734223472733,24.08833877801895,104053
280,-15.303831935958545,1000,0.2457325055235537,25.438561465740204,105053
281,-216.39086928901307,213,0.24450384299593592,23.185597681999205,105266
282,38.52948075188137,1000,0.24328132378095624,24.4905890750885,106266
283,111.24979620630995,1000,0.24206491716205145,30.387730803489685,107266
284,287.90502943508636,774,0.2408545925762412,23.2406431388855,108040
285,119.28578660310367,1000,0.23965031961336,22.011964688301088,109040
286,107.14393210115836,1000,0.2384520680152932,21.525971608161925,110040
287,96.16904621067424,1000,0.23725980767521673,35.86510478019714,111040
288,118.3809909516143,1000,0.23607350863684065,27.865179092884063,112040
289,107.34139957516437,1000,0.23489314109365644,19.502394547462462,113040
290,63.92412510540679,1000,0.23371867538818816,24.092525007724763,114040
291,279.8405076334407,338,0.23255008201124722,22.189303770065308,114378
292,83.44457551967436,1000,0.231387331601191,24.53549114704132,115378
293,66.06948253685295,1000,0.23023039494318503,24.957427985668183,116378
294,115.74684963295762,1000,0.2290792429684691,23.097998790740967,117378
295,88.9050914766927,1000,0.22793384675362674,15.804110922813415,118378
296,131.07765795504628,1000,0.22679417751985861,23.730329308509827,119378
297,-162.30709669151372,249,0.22566020663225933,10.001393733024598,119627
298,196.30262276397895,645,0.22453190559909803,25.34467143535614,120272
299,167.77552837055637,1000,0.22340924607110255,17.440430762767793,121272
300,100.51402206197818,1000,0.22229219984074702,16.104679975509644,122272
301,113.24659892154045,1000,0.2211807388415433,19.701682929992675,123272
302,65.71229327671634,1000,0.22007483514733558,24.60168754339218,124272
303,113.99000717051109,1000,0.2189744609715989,25.238471022844315,125272
304,92.37696280435655,1000,0.2178795886667409,26.876514813899995,126272
305,184.0094662408921,1000,0.2167901907234072,8.072073423862458,127272
306,160.72987014368067,1000,0.21570623976979014,24.474105656147003,128272
307,304.62329232959326,365,0.21462770857094118,11.299277126789093,128637
308,-396.9752362104808,114,0.21355457002808648,8.857943360805512,128751
309,174.7943755968821,1000,0.21248679717794605,14.188730343580247,129751
310,17.528777670867015,116,0.21142436319205632,15.212128492593765,129867
311,145.63760077986043,1000,0.21036724137609603,11.50630889415741,130867
312,174.76679210385518,835,0.20931540516921554,9.73534539461136,131702
313,175.12055624654636,1000,0.20826882814336947,9.381046952009202,132702
314,176.96499791805272,837,0.20722748400265262,10.529967356920242,133539
315,173.42227227264425,1000,0.20619134658263935,22.354332393407823,134539
316,81.11707912680308,1000,0.20516038984972615,10.3614930331707,135539
317,144.1203297547675,1000,0.2041345879004775,10.04663227379322,136539
318,158.62292928744273,1000,0.2031139149609751,13.618304849267005,137539
319,265.8915106449795,859,0.20209834538617025,10.05787070631981,138398
320,221.9718226593876,334,0.2010878536592394,12.17298334479332,138732
321,229.2380129281381,966,0.2000824143909432,7.492448526024819,139698
322,-24.335614392996447,77,0.19908200231898848,10.468544811606407,139775
323,48.37129534451873,145,0.19808659230739353,12.452953073978424,139920
324,140.60240210394062,1000,0.19709615934585656,11.307315806150436,140920
325,-121.11182549192421,179,0.19611067854912728,13.947594351768494,141099
326,-13.839782913739924,188,0.19513012515638165,21.787391477823256,141287
327,69.1386011139336,1000,0.19415447453059972,9.537672481536866,142287
328,-152.16348488659537,158,0.19318370215794672,11.211769800186158,142445
329,289.04250646145596,374,0.192217783647157,9.335241186022758,142819
330,71.62982197970967,1000,0.1912566947289212,11.699928822517395,143819
331,17.832866880528144,102,0.1903004112552766,7.652156088948249,143921
332,123.73443005548738,1000,0.18934890919900021,9.480615631341934,144921
333,144.9604074319506,1000,0.18840216465300522,9.355500206947326,145921
334,-118.8492329528743,92,0.18746015382974018,8.254094831943512,146013
335,231.78482640229396,566,0.1865228530605915,10.590719292163849,146579
336,78.2048814216981,1000,0.18559023879528855,10.143329037427902,147579
337,157.40328105070708,1000,0.1846622876013121,13.974143347740174,148579
338,150.15984068662732,1000,0.18373897616330553,8.913988999724388,149579
339,156.9131795247478,1000,0.182820281282489,7.871855245828629,150579
340,9.759344124171221,145,0.18190617987607657,8.657122848629951,150724
341,146.23892606412397,1000,0.18099664897669618,12.807911358475685,151724
342,148.8186531454622,1000,0.1800916657318127,17.367277448177337,152724
343,-44.55896805747042,110,0.17919120740315364,19.055624371170996,152834
344,128.06745508385728,1000,0.17829525136613786,7.647140614986419,153834
345,239.27129745034372,860,0.17740377510930716,12.268132055997848,154694
346,-308.4836438496303,678,0.17651675623376062,16.55497213602066,155372
347,-199.82931194249818,157,0.1756341724525918,9.081814796328544,155529
348,-150.37268896423114,159,0.17475600159032884,14.530901304483415,155688
349,-165.67982354032307,381,0.17388222158237718,11.161434276103973,156069
350,17.154069330350254,171,0.1730128104744653,11.720689084529877,156240
351,109.82166992595829,1000,0.17214774642209296,7.833260498642922,157240
352,102.79853301674223,1000,0.1712870076899825,10.52569452881813,158240
353,139.34882405873364,1000,0.17043057265153258,7.575623111128807,159240
354,-89.69711233470068,61,0.16957841978827493,12.855864440202714,159301
355,46.675376424726664,90,0.16873052768933355,11.746744283437728,159391
356,287.805600692261,923,0.1678868750508869,10.573277988433837,160314
357,67.33533307340707,1000,0.16704744067563246,12.717163950800895,161314
358,-19.08126801551988,1000,0.1662122034722543,6.906239784955979,162314
359,-113.64056053775178,154,0.16538114245489302,8.10457240819931,162468
360,252.3697528799623,807,0.16455423674261854,6.796728496551514,163275
361,-32.3951012903442,314,0.16373146555890544,7.359887573719025,163589
362,220.695420838192,644,0.16291280823111093,8.823562325239182,164233
363,114.27939877195652,1000,0.16209824418995536,8.126539416909218,165233
364,131.3234676225847,1000,0.16128775296900558,11.470727568864822,166233
365,227.99266671075233,335,0.16048131420416054,9.167916148900986,166568
366,-64.049705868323,85,0.15967890763313974,6.36505050778389,166653
367,150.9376041046821,1000,0.15888051309497406,12.658968015909196,167653
368,240.42164359733894,492,0.1580861105294992,12.149024365544319,168145
369,244.81241012236802,946,0.1572956799768517,9.34590825498104,169091
370,-363.4546677525858,225,0.15650920157696743,14.418308153152466,169316
371,265.10056471029355,272,0.1557266555690826,6.915649168491363,169588
372,147.257179385841,1000,0.1549480222912372,6.253939321041107,170588
373,218.45977411232766,748,0.15417328217978102,8.209793913960457,171336
374,288.6253301998502,454,0.1534024157688821,11.731846429109574,171790
375,2.580757574682309,166,0.1526354036900377,11.229719022512436,171956
376,-307.69283045981683,95,0.1518722266715875,8.804306502342223,172051
377,262.7139376119927,315,0.15111286553822956,7.243919414281845,172366
378,249.7093016099696,982,0.15035730121053842,12.355906610488892,173348
379,-455.7097694647463,233,0.14960551470448571,6.657457276582718,173581
380,-321.0633886726913,88,0.14885748713096328,8.38119015932083,173669
381,73.64720008138349,1000,0.14811319969530845,10.692264730930328,174669
382,-187.1154579771145,98,0.1473726336968319,7.975325167775154,174767
383,-252.71734365491878,84,0.14663577052834775,7.794744611382485,174851
384,39.5348395236054,1000,0.14590259167570602,11.153444399237634,175851
385,287.3835876200976,450,0.1451730787173275,6.744797805547714,176301
386,278.85560851506466,478,0.14444721332374086,8.6662663179636,176779
387,277.3856601863718,313,0.14372497725712216,7.108332296609879,177092
388,121.94605391131847,1000,0.14300635237083656,9.370186086893082,178092
389,279.1213234724396,616,0.14229132060898236,9.808291653394699,178708
390,243.5649266454422,530,0.14157986400593744,4.960349715352058,179238
391,292.5724425545829,733,0.14087196468590776,9.494994592666625,179971
392,85.08320751055572,1000,0.14016760486247823,11.952733616232871,180971
393,195.38877237681766,828,0.13946676683816583,12.023408533930779,181799
394,230.65148060653894,551,0.138769433003975,8.207186369299889,182350
395,185.4454501088755,740,0.13807558583895513,11.401074332594872,183090
396,241.62327229289545,275,0.13738520790976036,10.502047855854034,183365
397,105.66321646770824,1000,0.13669828187021155,12.212222312688828,184365
398,-142.18107630145275,225,0.13601479046086049,6.6537228405475615,184590
399,200.73513637695376,760,0.1353347165085562,7.405527228713035,185350
400,167.96719790720257,1000,0.1346580429260134,6.268478320837021,186350
401,238.50057439782898,337,0.13398475271138335,9.591235302090645,186687
402,156.98566452191398,1000,0.13331482894782642,5.0390802919864655,187687
403,245.8411671265076,353,0.13264825480308728,7.536905919313431,188040
404,262.8943883524561,264,0.13198501352907185,10.053561599254609,188304
405,245.72022845120182,976,0.1313250884614265,10.897161653637886,189280
406,273.744805277527,819,0.13066846301911936,10.268518020510674,190099
407,146.2190605200467,1000,0.13001512070402377,8.823789854049682,191099
408,174.2306030868996,1000,0.12936504510050365,6.976184831261635,192099
409,268.5136519606767,726,0.12871821987500112,8.40999835729599,192825
410,246.53187877923,242,0.12807462877562611,7.6911236470937725,193067
411,256.2666102535384,659,0.12743425563174798,5.996520514190197,193726
412,245.0990546432496,467,0.12679708435358925,7.00727620959282,194193
413,210.10346806607905,550,0.1261630989318213,6.42589198410511,194743
414,235.23604145933808,292,0.1255322834371622,6.01770176500082,195035
415,250.50819578958757,530,0.12490462201997637,9.879107949137687,195565
416,141.80879342835368,716,0.1242800989098765,10.75759122610092,196281
417,235.47892170653773,300,0.12365869841532712,7.430790215730667,196581
418,-254.17627448693912,99,0.12304040492325048,4.658024003505707,196680
419,245.43177443901087,546,0.12242520289863423,9.9495230281353,197226
420,104.99832373263698,1000,0.12181307688414106,12.782750298976898,198226
421,247.7996433130404,386,0.12120401149972035,11.78045433163643,198612
422,246.4249028973234,408,0.12059799144222175,8.68099396109581,199020
423,236.254160319181,290,0.11999500148501063,11.019117339849473,199310
424,223.53081256184308,294,0.11939502647758558,10.955479071140289,199604
425,258.6259477465215,254,0.11879805134519765,5.709095568656921,199858
426,270.6555058150287,685,0.11820406108847166,7.92839143037796,200543
