episode,reward,length,epsilon,mean_loss,steps
1,-423.7301897749603,90,0.99,9.13619824556204,90
2,-149.09085463436423,82,0.9801,55.06175611257553,172
3,-55.51274818912306,69,0.9702989999999999,60.38658439397812,241
4,-137.9639154982649,127,0.96059601,46.275339918136595,368
5,-166.32021692575472,93,0.9509900498999999,28.866839973926545,461
6,-153.81287714522807,84,0.9414801494009999,16.73224328160286,545
7,-79.02617802508365,82,0.9320653479069899,18.18289804339409,627
8,-375.42444482407086,105,0.92274469442792,23.538153371810914,732
9,-249.61755958992504,100,0.9135172474836407,25.034289996623993,832
10,-353.24081298482804,102,0.9043820750088043,37.531030173301694,934
11,-72.88311857332113,67,0.8953382542587163,32.81345509529114,1001
12,-141.38906924010072,98,0.8863848717161291,34.26859620571136,1099
13,-136.20379616562715,100,0.8775210229989678,41.2131160402298,1199
14,-103.34540918457374,94,0.8687458127689781,35.629665353298186,1293
15,-96.14568829758261,92,0.8600583546412883,36.21229097604751,1385
16,-119.82543380108307,85,0.8514577710948754,30.678828488588334,1470
17,-107.39889469259057,87,0.8429431933839266,40.37413735747337,1557
18,-81.01708342855659,75,0.8345137614500874,52.36466808319092,1632
19,-111.91476251821514,113,0.8261686238355865,49.126092261075975,1745
20,13.003394832090237,100,0.8179069375972307,60.05022691845894,1845
21,-71.6533789529155,99,0.8097278682212583,54.99980813503265,1944
22,-88.49872282687328,77,0.8016305895390458,45.94695261716843,2021
23,-131.29025157933228,117,0.7936142836436553,32.19768137931824,2138
24,-105.68754365061558,91,0.7856781408072188,36.57188804149628,2229
25,-3.479740791112903,137,0.7778213593991465,29.696396555900574,2366
26,-72.83091858220352,109,0.7700431458051551,52.14899491190911,2475
27,-113.78842087040152,96,0.7623427143471035,45.43198440313339,2571
28,-135.60729301131565,100,0.7547192872036325,35.91007853150368,2671
29,-207.53910839811118,136,0.7471720943315961,32.553592240810396,2807
30,-33.20034242443569,160,0.7397003733882802,32.07136194944382,2967
31,-81.09759055253585,107,0.7323033696543974,38.999241431951525,3074
32,-38.86382124022266,120,0.7249803359578534,37.85595671415329,3194
33,-167.92285962670817,133,0.7177305325982748,28.889885745048524,3327
34,-48.301227556379565,122,0.7105532272722921,45.761772153377535,3449
35,37.213088499573274,143,0.7034476949995692,39.98196281671524,3592
36,-55.971356730347914,73,0.6964132180495735,35.09999173164368,3665
37,-215.87785810918913,125,0.6894490858690777,36.58564711093903,3790
38,-68.7184773348363,139,0.682554595010387,29.63391239643097,3929
39,-77.17198301202653,148,0.6757290490602831,45.5304877614975,4077
40,-56.530706312047535,85,0.6689717585696803,31.904220148324967,4162
41,-39.39711778558221,148,0.6622820409839835,32.42001671791077,4310
42,-89.65574757457081,87,0.6556592205741436,37.6542700111866,4397
43,-52.26707191536889,101,0.6491026283684022,26.38300483584404,4498
44,-42.56870508371084,100,0.6426116020847181,36.20739756941796,4598
45,-40.945415105291545,88,0.6361854860638709,41.534949766397474,4686
46,-12.773340142072186,112,0.6298236312032323,29.04450826883316,4798
47,-51.720335308034976,121,0.6235253948912,40.61713129758835,4919
48,-97.6263156409713,139,0.617290140942288,33.00359258174896,5058
49,-17.17146194987943,197,0.6111172395328651,30.033020325899123,5255
50,-58.78233417625477,125,0.6050060671375365,24.079210224151613,5380
51,-100.35567979952684,110,0.5989560064661611,31.178131420612335,5490
52,-70.68843892554598,116,0.5929664464014994,33.25556378126144,5606
53,-60.88999967188472,107,0.5870367819374844,24.481642553806306,5713
54,-72.43279241408518,131,0.5811664141181095,24.07870406150818,5844
55,-18.718249085673165,111,0.5753547499769285,28.252307877540588,5955
56,-29.192767923873603,107,0.5696012024771592,24.371395523548127,6062
57,-182.88619274422325,128,0.5639051904523876,30.58211635708809,6190
58,-40.11403621689138,123,0.5582661385478638,28.830648379325865,6313
59,-36.34686486404085,137,0.5526834771623851,24.160268168449402,6450
60,-24.616877224380787,84,0.5471566423907612,28.774281277656556,6534
61,32.665802163778665,107,0.5416850759668536,26.737873463630677,6641
62,13.290354747333893,119,0.536268225207185,24.908473014831543,6760
63,-12.216397419755936,130,0.5309055429551132,30.79570919394493,6890
64,-54.15798003475626,86,0.525596487525562,26.545767407417298,6976
65,-4.757283848799389,157,0.5203405226503064,27.916684596538545,7133
66,-60.4008150960472,125,0.5151371174238033,29.12372663140297,7258
67,114.20022463573778,1000,0.5099857462495653,24.761567540168762,8258
68,-47.01387153962119,107,0.5048858887870696,22.34040834188461,8365
69,-101.33635304497442,101,0.4998370298991989,30.164555909633638,8466
70,73.89976533525699,1000,0.49483865960020695,27.35070605754852,9466
71,-2.3030249181091023,104,0.4898902730042049,31.277082271575928,9570
72,-273.80468390581814,392,0.48499137027416284,24.340774717330934,9962
73,-336.5367838538599,409,0.4801414565714212,24.449396357536315,10371
74,12.5450539867456,173,0.475340042005707,25.311992001533508,10544
75,-89.71742297284247,150,0.47058664158564995,25.253412749767303,10694
76,-60.740448367001704,167,0.4658807751697934,26.204432210922242,10861
77,-28.261566677566123,109,0.4612219674180955,25.27516476392746,10970
78,-76.74523636096389,402,0.45660974774391455,29.512180173397063,11372
79,-52.39854356717251,172,0.4520436502664754,27.67104849100113,11544
80,-178.62955273704517,714,0.44752321376381066,26.571550250053406,12258
81,23.23279579111928,1000,0.44304798162617254,23.208804202079772,13258
82,-84.00006023759866,123,0.4386175018099108,31.34212042570114,13381
83,-141.25333732591366,136,0.4342313267918117,27.356261367797853,13517
84,-93.07527321749026,279,0.4298890135238936,31.6778160905838,13796
85,-25.130270143802104,1000,0.42559012338865465,28.20066824436188,14796
86,-19.91280321103457,181,0.4213342221547681,29.949429204463957,14977
87,-91.20997272414417,129,0.41712087993322045,22.27083855867386,15106
88,-263.04092293517726,287,0.41294967113388825,36.83473629951477,15393
89,-71.59551869387667,145,0.40882017442254937,25.491565704345703,15538
90,66.3273107080718,1000,0.4047319726783239,31.54288237810135,16538
91,-74.32860686557333,235,0.40068465295154065,34.52308488368988,16773
92,-135.09848108225157,276,0.39667780642202527,27.069223597049714,17049
93,57.00653841080315,1000,0.392711028357805,29.439132604599,18049
94,-7.140456500453865,108,0.38878391807422696,37.55768710374832,18157
95,49.97980207883247,1000,0.3848960788934847,24.773534367084505,19157
96,-51.144712145745785,198,0.38104711810454983,29.802336378097536,19355
97,-93.00987639499755,183,0.37723664692350434,30.40072456598282,19538
98,-181.67066929478597,108,0.37346428045426927,20.09826521396637,19646
99,10.66085799908529,1000,0.36972963764972655,32.91847655534744,20646
100,-77.42746884644689,118,0.36603234127322926,19.04137521505356,20764
101,85.99714533557047,1000,0.36237201786049694,28.223675501346587,21764
102,-78.5253788118603,135,0.358748297681892,29.69726894378662,21899
103,-153.21041443963364,200,0.35516081470507305,22.635482766628265,22099
104,145.87954383948167,1000,0.3516092065580223,26.65519329071045,23099
105,115.4345281790365,1000,0.34809311449244207,24.79097134113312,24099
106,83.92899928179266,1000,0.34461218334751764,25.706628923416137,25099
107,79.02617877972926,1000,0.34116606151404244,30.230098091363907,26099
108,-64.36680582433434,128,0.337754400898902,17.0223475587368,26227
109,99.08680656228859,1000,0.334376856889913,31.218910300731658,27227
110,18.498119970027204,1000,0.33103308832101386,22.713937504291536,28227
111,93.88590667443445,1000,0.3277227574378037,24.31416834950447,29227
112,-213.39092144123163,158,0.3244455298634257,33.01545161247253,29385
113,-30.413069630805097,148,0.3212010745647914,29.471449811458587,29533
114,-42.3974676612029,99,0.3179890638191435,29.550787703990935,29632
115,-36.67548115768872,119,0.31480917318095203,26.021553316116332,29751
116,93.13906206964907,1000,0.3116610814491425,22.89555953979492,30751
117,-31.216134544693077,89,0.30854447063465107,20.59690304517746,30840
118,-85.00570407407112,110,0.30545902592830454,21.250789680480956,30950
119,83.96865556502803,1000,0.3024044356690215,22.063324224948882,31950
120,-79.06408815734008,137,0.29938039131233124,27.674944677352904,32087
121,-30.922396401881656,114,0.2963865873992079,22.596614735126494,32201
122,89.33658330952156,1000,0.29342272152521587,23.606403484344483,33201
123,-6.39903523822467,139,0.2904884943099637,30.580909790992738,33340
124,163.7786664584677,1000,0.28758360936686406,20.203037521839143,34340
125,55.410516525866186,1000,0.2847077732731954,20.305618572235108,35340
126,70.15792929969788,1000,0.28186069554046345,19.49138692498207,36340
127,115.42833310369929,1000,0.2790420885850588,24.557207276821135,37340
128,-28.61791263402658,120,0.2762516676992082,19.941952311992644,37460
129,-104.38581030441235,108,0.27348915102221616,14.745974607467652,37568
130,3.2331701809997924,143,0.270754259511994,24.988643925189972,37711
131,-65.45336556472547,115,0.26804671691687404,17.786660656929016,37826
132,83.70811119911407,1000,0.2653662497477053,13.640509395599365,38826
133,-65.14035717812925,103,0.2627125872502282,20.466153413057327,38929
134,-231.12821604742788,145,0.2600854613777259,16.978648209571837,39074
135,-209.21937019284638,240,0.2574846067639487,25.313283998966217,39314
136,-16.139949544705672,95,0.2549097606963092,14.835607724189758,39409
137,73.96432887804313,1000,0.2523606630893461,25.93726364374161,40409
138,77.123421510047,1000,0.24983705645845267,22.50980368375778,41409
139,-32.288728428484546,126,0.24733868589386815,24.83856005191803,41535
140,73.36691040621116,1000,0.24486529903492946,26.491355217695236,42535
141,45.35609309975269,1000,0.24241664604458016,32.78989424705505,43535
142,-43.00647312945979,112,0.23999247958413436,18.036903026103975,43647
143,7.8956882113899525,149,0.23759255478829303,28.262641069889067,43796
144,61.442708524781935,1000,0.2352166292404101,31.00568772673607,44796
145,124.54701387185548,1000,0.232864462948006,18.757162384986877,45796
146,111.85984447015369,1000,0.23053581831852593,20.945698115825653,46796
147,29.991964805873806,1000,0.22823046013534068,17.523011388778688,47796
148,142.67690740522866,501,0.22594815553398728,24.354549649953842,48297
149,-180.62445820173747,600,0.22368867397864742,26.5389430809021,48897
150,91.02933340154476,1000,0.22145178723886094,26.05723449230194,49897
151,-97.70691589222025,684,0.21923726936647234,17.88230139017105,50581
152,-133.75197021406981,270,0.2170448966728076,27.082233498096468,50851
153,237.04084840927155,773,0.21487444770607952,21.98668023109436,51624
154,253.7533809654471,491,0.21272570322901874,17.108910537958145,52115
155,39.99672071791508,140,0.21059844619672854,31.44295776605606,52255
156,75.76501588974543,1000,0.20849246173476127,22.74597691655159,53255
157,-190.7233242458086,346,0.20640753711741366,20.12193325281143,53601
158,-302.7527144643338,502,0.20434346174623952,21.303503975868225,54103
159,84.33722432384828,1000,0.20230002712877712,19.827828379869462,55103
160,120.97550446032805,1000,0.20027702685748935,23.743883724212647,56103
161,122.13786781903787,1000,0.19827425658891445,14.401023290157319,57103
162,-218.1020784563437,294,0.1962915140230253,14.277180843353271,57397
163,101.81175051927242,1000,0.19432859888279505,26.517025941610335,58397
164,6.268747448324254,1000,0.1923853128939671,20.96391126394272,59397
165,97.28732042818524,1000,0.19046145976502743,15.915510687828064,60397
166,259.9843593139411,682,0.18855684516737714,14.018904039859772,61079
167,37.2686178153712,1000,0.18667127671570335,11.506916693449021,62079
168,-66.5323143076541,1000,0.18480456394854633,18.887162268161774,63079
169,51.75746166631026,1000,0.18295651830906087,26.124128293991088,64079
170,65.95167419848521,1000,0.18112695312597027,12.95384263753891,65079
171,153.9597955785894,784,0.17931568359471056,9.98124679684639,65863
172,93.50439913987117,1000,0.17752252675876345,13.11858855009079,66863
173,131.66272416463897,1000,0.17574730149117582,10.982876665592194,67863
174,256.8677748166816,614,0.17398982847626407,11.955039273500443,68477
175,151.6596367284447,1000,0.17224993019150142,13.610964572429657,69477
176,80.14286954504634,1000,0.1705274308895864,12.34195621728897,70477
177,-35.54384572430021,562,0.16882215658069055,13.89758911728859,71039
178,63.31355133849701,1000,0.16713393501488363,11.401882557868957,72039
179,137.71482962384604,1000,0.16546259566473479,8.161751272082329,73039
180,125.47668992485552,1000,0.16380796970808745,10.922535316944122,74039
181,120.39613093203504,1000,0.16216989001100657,11.276441864967346,75039
182,152.51351066199504,1000,0.1605481911108965,16.130100335478783,76039
183,128.27955427563438,1000,0.15894270919978754,11.883398485183715,77039
184,214.5854595645087,888,0.15735328210778965,8.570870893001556,77927
185,213.23820842617124,813,0.15577974928671176,6.927926830053329,78740
186,53.8101753643587,1000,0.15422195179384465,12.281160449385643,79740
187,132.0211250915726,927,0.1526797322759062,10.213544386029243,80667
188,-201.08854425656918,129,0.15115293495314713,9.326931539773941,80796
189,262.33833689877713,768,0.14964140560361566,8.655951197147369,81564
190,249.97595211994917,808,0.1481449915475795,12.10913942694664,82372
191,207.13029818784833,915,0.1466635416321037,8.517399626970292,83287
192,267.392788357541,753,0.14519690621578268,7.537135536074638,84040
193,242.20131616801973,240,0.14374493715362485,5.916352370381356,84280
194,-54.05623235743697,94,0.1423074877820886,7.269340930581093,84374
195,238.88791844252333,329,0.1408844129042677,7.755916950702667,84703
196,249.33811955168875,498,0.13947556877522502,12.455055972933769,85201
197,-11.79825950833164,156,0.13808081308747278,17.080314788222314,85357
198,-365.8806751599745,581,0.13670000495659804,10.186391742229462,85938
199,244.0129758315898,915,0.13533300490703207,13.095524669885636,86853
200,235.34495446315518,350,0.13397967485796175,8.175399512052536,87203
201,113.02952260904763,1000,0.13263987810938213,9.918243817687035,88203
202,-28.058523508941363,146,0.1313134793282883,7.828059939742088,88349
203,9.076514915903886,122,0.13000034453500542,7.187663462162018,88471
204,118.22826147487213,1000,0.12870034108965536,15.223538951277733,89471
205,-71.67543187741283,119,0.12741333767875881,8.699390776753425,89590
206,-40.984240846279576,95,0.12613920430197123,13.200146668553352,89685
207,-8.344749145073678,82,0.12487781225895152,8.839038039445876,89767
208,-18.976692795779513,159,0.123629034136362,8.512637967467308,89926
209,-162.92944428352433,235,0.12239274379499838,10.53364142715931,90161
210,-118.90830871960408,234,0.1211688163570484,16.795699319243433,90395
211,-57.57032149310248,159,0.11995712819347792,9.427954055070877,90554
212,235.67303590256412,587,0.11875755691154315,20.53245533823967,91141
213,-65.43666605197835,138,0.11756998134242772,8.6673692715168,91279
214,129.9675257712187,1000,0.11639428152900344,7.061962589025497,92279
215,-5.675245935608814,132,0.11523033871371341,11.202920293211937,92411
216,256.9289383823627,466,0.11407803532657627,11.894040769934655,92877
217,243.51158638764738,291,0.11293725497331052,12.895031626820565,93168
218,230.98542762492127,509,0.1118078824235774,10.320494802594185,93677
219,234.44074278041074,305,0.11068980359934164,14.779473332762718,93982
220,231.52520810352033,280,0.10958290556334822,6.0946762251853945,94262
221,102.151089894885,1000,0.10848707650771475,8.6946700912714,95262
222,253.28121167389838,405,0.1074022057426376,7.221086772680283,95667
223,-286.67001874594854,108,0.10632818368521123,5.143199761211872,95775
224,-84.0505741316504,167,0.10526490184835911,7.355895041227341,95942
225,213.38097769618656,408,0.10421225282987552,8.608182915449142,96350
226,267.265707066079,679,0.10317013030157676,10.057163858413697,97029
227,233.23887034460984,783,0.10213842899856099,12.931024738550185,97812
228,267.9774828511946,433,0.10111704470857538,9.399780071377755,98245
229,7.348557948573529,213,0.10010587426148963,18.4873842304945,98458
230,235.31884964510053,966,0.09910481551887473,9.869100153446198,99424
231,-60.69937937597355,1000,0.09811376736368599,16.46251031279564,100424
232,244.07508974317153,693,0.09713262969004913,14.763110023736953,101117
233,167.71083357085945,825,0.09616130339314863,17.34859684407711,101942
234,252.02946059528645,556,0.09519969035921715,11.804988138079644,102498
235,254.98338295576707,739,0.09424769345562498,9.366588250994683,103237
236,197.43424220336647,273,0.09330521652106873,14.076093327999114,103510
237,235.49904054301703,661,0.09237216435585804,8.207469537258149,104171
238,241.5586728746726,456,0.09144844271229946,8.264631360769272,104627
239,267.0560688450877,279,0.09053395828517646,14.14345481455326,104906
240,261.8384771993757,404,0.08962861870232469,10.117173963785172,105310
241,236.52016802960884,433,0.08873233251530144,10.86225134074688,105743
242,133.52616108159393,1000,0.08784500919014843,7.582697828412056,106743
243,221.30753310515752,318,0.08696655909824694,9.671195689439774,107061
244,237.04362552857398,209,0.08609689350726446,6.4182514679431915,107270
245,269.00088758687883,514,0.08523592457219181,9.548015044927597,107784
246,266.0818261979391,434,0.0843835653264699,13.819143834114074,108218
247,285.7465218588222,260,0.0835397296732052,9.062926882505417,108478
248,267.07693827461014,352,0.08270433237647315,8.098680049180984,108830
249,227.9669316332933,381,0.08187728905270841,11.15247815489769,109211
250,229.08197232055736,543,0.08105851616218133,10.519373540878297,109754
251,233.38214096001056,359,0.08024793100055952,14.413606309890747,110113
252,173.40154649298222,487,0.07944545169055392,11.294253885149956,110600
253,-79.58736912487544,368,0.07865099717364837,10.643113552331924,110968
254,234.853225434784,404,0.07786448720191189,9.913867873549462,111372
255,246.17172714844907,496,0.07708584232989277,12.716259146928786,111868
256,254.9417794507446,454,0.07631498390659384,11.489134977459907,112322
257,161.47586065605645,324,0.07555183406752791,17.543569296598434,112646
258,254.47796377851142,283,0.07479631572685264,10.392366052865983,112929
259,269.0998623579941,372,0.07404835256958411,10.473424180150031,113301
260,278.8227280800572,228,0.07330786904388827,11.685542449355125,113529
261,210.9732302492912,362,0.07257479035344938,12.340689021348954,113891
262,-175.9479387831836,182,0.07184904244991488,14.742860914468766,114073
263,245.1025096154449,280,0.07113055202541574,10.856678051948547,114353
264,252.67249646866537,306,0.07041924650516158,16.479471300840377,114659
265,-221.26514729674204,125,0.06971505404010997,11.384706103801728,114784
266,201.79981710569635,467,0.06901790349970886,7.642568336725235,115251
267,227.34731035386227,498,0.06832772446471178,27.10333779990673,115749
268,248.11696072810466,240,0.06764444722006466,12.044083440899849,115989
269,245.96089674355264,229,0.066968002747864,9.152451829910278,116218
270,252.6568107320635,324,0.06629832272038537,10.517652522921562,116542
271,200.5339816023798,354,0.06563533949318151,13.512087802886963,116896
272,240.02679543873862,549,0.06497898609824969,12.11815932571888,117445
273,245.14710975392265,249,0.0643291962372672,5.949643770456314,117694
274,209.04423316582069,278,0.06368590427489453,11.800445185303689,117972
275,283.6421232543163,261,0.06304904523214558,11.277102830410003,118233
276,285.66320580327886,290,0.06241855477982412,15.016292775869369,118523
277,247.39488133811136,301,0.06179436923202588,12.47318646132946,118824
278,190.71262068336955,241,0.06117642553970562,12.19304020166397,119065
279,270.30745514924354,235,0.06056466128430856,14.378793032765389,119300
280,211.01128499443274,339,0.05995901467146548,9.608347488641739,119639
281,265.638911380135,365,0.05935942452475082,12.92717298090458,120004
282,266.7197239942251,504,0.058765830279503314,11.518902335166931,120508
283,261.0372550591052,404,0.05817817197670828,12.324572061300278,120912
284,224.18440213217193,268,0.057596390256941195,10.724911363720894,121180
285,278.37064454092723,667,0.05702042635437178,12.158254393339156,121847
286,202.70077866441733,505,0.05645022209082806,14.592736060619353,122352
287,296.8761813363623,255,0.05588571986991978,10.954375336766242,122607
288,238.0113333717327,300,0.055326862671220584,12.993066710233688,122907
289,249.62204692741992,202,0.05477359404450838,10.376416617631913,123109
290,-56.63321872425998,348,0.054225858104063294,15.522980527877808,123457
291,237.69353040617167,369,0.05368359952302266,10.11360219836235,123826
292,186.6424775684448,436,0.053146763527792434,9.083816721439362,124262
293,-294.32379729973024,260,0.052615295892514506,13.368938871622085,124522
294,260.304834413147,430,0.052089142933589364,5.967388882637024,124952
295,239.5818674724665,310,0.05156825150425347,18.329875091314317,125262
296,224.79719779939106,318,0.051052568989210935,21.80545703113079,125580
297,201.76308888458084,318,0.05054204329931883,12.746700500249863,125898
298,240.2121503853407,648,0.05003662286632564,12.730992790460586,126546
299,233.24210024629633,429,0.04953625663766238,12.750834559202195,126975
300,182.1078964299958,613,0.04904089407128576,7.846389814019203,127588
301,271.78530635720017,328,0.0485504851305729,5.653173882961273,127916
302,247.60387105274518,484,0.048064980279267165,10.589228175878524,128400
303,238.3821033804096,300,0.04758433047647449,11.19718138217926,128700
304,253.74105873328728,252,0.04710848717170975,7.807339342832566,128952
305,36.138083549300575,249,0.04663740229999265,11.552523078918457,129201
306,259.5455795156828,361,0.04617102827699272,11.283930928707123,129562
307,249.17720352911903,356,0.045709317994222794,12.539436388015748,129918
308,-233.183782578993,360,0.04525222481428057,15.16373810172081,130278
309,263.38298466672364,281,0.04479970256613776,9.558885408043862,130559
310,-38.109263971790256,157,0.04435170554047638,19.434644807577133,130716
311,253.7464528642563,211,0.043908188485071616,17.184416111707687,130927
312,264.90355989284774,273,0.0434691066002209,8.620620906352997,131200
313,274.8026667325694,500,0.04303441553421869,18.207767295837403,131700
314,-47.70454824223859,92,0.0426040713788765,8.850854302644729,131792
315,298.9299847147114,286,0.04217803066508773,15.534467601776123,132078
316,38.62670656387084,137,0.04175625035843686,12.032520861029624,132215
317,248.04907815668255,213,0.041338687854852486,16.058211240172387,132428
318,263.5870292050992,252,0.04092530097630396,5.481111525893211,132680
319,6.529341032586544,227,0.040516047966540916,12.977168288230896,132907
320,-48.23724220335519,120,0.04011088748687551,17.956175997257233,133027
321,256.77085445064046,252,0.03970977861200675,16.957319399118422,133279
322,220.62669064568408,247,0.03931268082588668,18.208490128517152,133526
323,-27.81727317816457,118,0.03891955401762781,13.393122170567512,133644
324,292.2921152865863,332,0.03853035847745153,17.970683504343032,133976
325,239.63732536492938,351,0.03814505489267701,17.24252353787422,134327
326,277.5166230337149,235,0.03776360434375024,15.804588023424149,134562
327,217.5513833842286,428,0.03738596830031274,17.712949689626694,134990
328,-55.94247751495203,143,0.03701210861730961,23.892262910604476,135133
329,-131.63694863079007,218,0.03664198753113651,20.31418366074562,135351
330,310.4148943283027,309,0.036275567655825146,13.266604194641113,135660
331,252.9184534627435,203,0.03591281197926689,13.822273181676865,135863
332,180.92052394537595,395,0.035553683859474224,15.22041021823883,136258
333,304.28241904592596,259,0.03519814702087948,19.556100484132767,136517
334,281.1561050818398,505,0.03484616555067068,18.829971780776976,137022
335,290.5474098814104,340,0.034497703895163975,24.010495053529738,137362
336,241.2032166153383,351,0.03415272685621234,10.805034122467042,137713
337,236.64078475694188,310,0.03381119958765021,9.639464087486267,138023
338,267.52230281120984,304,0.03347308759177371,11.007457064390183,138327
339,251.4254121376716,284,0.03313835671585597,24.23245111942291,138611
340,262.7864760056416,335,0.03280697314869741,12.081310513615609,138946
341,233.31670110081723,269,0.032478903417210436,17.861129947304725,139215
342,-62.06207308642065,322,0.032154114383038335,19.016805766224863,139537
343,224.39510883448963,374,0.03183257323920795,18.999457852840422,139911
344,288.57448137587585,241,0.03151424750681587,17.33106832385063,140152
345,-243.43487471088446,221,0.03119910503174771,8.710817312002183,140373
346,-26.446217813170364,184,0.030887113981430233,14.501634916067124,140557
347,262.4253559942058,275,0.03057824284161593,15.152809215188027,140832
348,243.49453432354528,248,0.03027246041319977,9.02054854631424,141080
349,237.74910320060272,307,0.029969735809067772,13.829022855758668,141387
350,272.62207075589345,540,0.029670038450977095,13.373663811683654,141927
351,233.6779215283602,260,0.029373338066467324,9.274191386699677,142187
352,292.2552855570623,398,0.02907960468580265,9.157609449625015,142585
353,268.1991996958086,239,0.028788808638944622,19.81872912824154,142824
354,280.9550153183643,306,0.028500920552555174,10.067954171299935,143130
355,296.1196776527037,307,0.028215911347029624,17.52041508615017,143437
356,271.4854493517961,293,0.027933752233559327,16.40916700720787,143730
357,273.9171521982284,269,0.027654414711223735,13.73697014927864,143999
358,305.0783003911291,215,0.027377870564111496,12.578692041039467,144214
359,289.0855706053507,247,0.027104091858470382,16.09612030863762,144461
360,247.74256473775986,236,0.026833050939885677,16.754795808196068,144697
361,237.93217217779667,213,0.02656472043048682,15.848714689612388,144910
362,252.64547019463646,356,0.02629907322618195,7.47560344517231,145266
363,289.6422462386562,251,0.026036082493920133,21.91450548529625,145517
364,265.8068506850502,276,0.02577572166898093,10.698170768022537,145793
365,256.79324849543445,303,0.025517964452291122,16.01788264632225,146096
366,253.3952998764184,354,0.02526278480776821,20.62873097062111,146450
367,237.17656787395515,287,0.025010156959690527,21.81884856581688,146737
368,-132.77379942950085,442,0.02476005539009362,9.68190980553627,147179
369,221.20373701114534,572,0.024512454836192684,7.822167304158211,147751
370,263.3179294051904,330,0.024267330287830756,12.431446069478989,148081
371,262.71880635224386,339,0.024024656984952448,21.436053502559663,148420
372,270.37707600387796,274,0.023784410415102923,23.318274813294412,148694
373,283.1393406960063,212,0.023546566310951894,14.411157017946243,148906
374,186.37857852920277,872,0.023311100647842375,18.57382739663124,149778
375,246.0318965107856,393,0.02307798964136395,7.911360450387001,150171
376,265.71591911168036,215,0.022847209744950314,13.726298925876618,150386
377,266.93390136024595,461,0.02261873764750081,12.178266295194625,150847
378,257.7004819224,255,0.022392550271025803,10.063625639081001,151102
379,253.19538942400297,465,0.022168624768315544,16.557657259702683,151567
380,257.2861044127864,258,0.02194693852063239,7.345862550139427,151825
381,257.6006615651798,256,0.021727469135426065,11.808776994943619,152081
382,315.1999295063571,263,0.021510194444071803,16.78076375722885,152344
383,276.90727945589754,271,0.021295092499631085,12.73341229557991,152615
384,17.113229240644017,148,0.021082141574634772,13.23759447813034,152763
385,239.13980398758653,290,0.020871320158888425,8.017517160773277,153053
386,281.2853156704716,255,0.020662606957299542,13.035576221942902,153308
387,276.6928836505487,252,0.020455980887726547,16.082803125977517,153560
388,258.8804550162379,205,0.02025142107884928,16.321035577058794,153765
389,255.31483371055063,428,0.020048906868060788,12.01350610435009,154193
390,288.53515620259986,313,0.01984841779938018,12.206950306892395,154506
391,234.57773996374357,774,0.019649933621386378,10.01588374197483,155280
392,241.05927608321107,490,0.019453434285172513,15.404538440704346,155770
393,214.70600981173436,409,0.019258899942320787,17.671736521720888,156179
394,243.61920539599504,265,0.01906631094289758,9.16659914135933,156444
395,198.92477210343424,438,0.018875647833468602,10.901655789017678,156882
396,271.19732028677356,229,0.018686891355133916,8.050713539123535,157111
397,209.72315987968776,690,0.018500022441582577,9.416549490690231,157801
398,265.3397598970838,327,0.01831502221716675,24.37599821448326,158128
399,266.28828671498064,249,0.018131871994995084,16.88959943652153,158377
400,252.29218938350172,273,0.017950553275045134,15.21404015660286,158650
401,251.97797117393375,313,0.017771047742294682,8.298780584335328,158963
402,275.83494418250217,227,0.017593337264871736,15.281084265112877,159190
403,229.5894731468106,471,0.01741740389222302,10.878252539634705,159661
404,-52.14054916282227,213,0.01724322985330079,22.287469133734703,159874
405,283.75574674024983,270,0.017070797554767782,9.802411248087884,160144
406,257.3340996489797,270,0.016900089579220106,18.267644790410994,160414
407,284.02638073657033,298,0.016731088683427906,20.592605364918708,160712
408,217.78361155182427,504,0.016563777796593626,11.926101071834564,161216
409,229.60752113657384,301,0.016398140018627688,7.2326105999946595,161517
410,244.19937743543258,279,0.01623415861844141,13.619417020082473,161796
411,264.04531146140914,328,0.016071817032256998,10.075463420152664,162124
412,267.094208292956,576,0.01591109886193443,14.049030921459199,162700
413,269.4056759238685,221,0.015751987873315085,12.759667140841485,162921
414,285.05202248066917,240,0.015594467994581935,16.324814988970758,163161
415,274.47264796508114,230,0.015438523314636115,13.512335053682328,163391
416,285.3086800075846,188,0.015284138081489753,7.101564816832543,163579
417,272.0811680422567,296,0.015131296700674856,10.602575651407243,163875
418,243.34307083334994,260,0.014979983733668108,6.939819028377533,164135
419,274.1791039878831,165,0.014830183896331426,19.44543556511402,164300
420,249.0608479159203,198,0.014681882057368112,16.825577255487442,164498
421,255.53736326149655,347,0.01453506323679443,12.203185064196587,164845
422,303.9798437134665,182,0.014389712604426485,18.59902104794979,165027
423,183.73444325034313,409,0.01424581547838222,13.45458204984665,165436
424,282.8767755076284,213,0.014103357323598397,14.757811216115952,165649
425,20.996502400715528,156,0.013962323750362413,20.100024429559706,165805
426,252.09720494385178,255,0.013822700512858789,22.52263520896435,166060
427,222.0174783383484,386,0.0136844735077302,29.185103091001512,166446
428,232.7644618079616,246,0.013547628772652899,11.012126477956771,166692
429,266.12581959937063,269,0.01341215248492637,7.862230754494667,166961
430,281.7943094040676,315,0.013278030960077106,17.89305253624916,167276
431,276.42965431679664,193,0.013145250650476335,9.139676948189736,167469
432,215.62122464584348,260,0.01301379814397157,20.370845144987108,167729
433,236.91454744394085,263,0.012883660162531854,9.061988806128502,167992
434,29.02993499739617,210,0.012754823560906535,17.370223861336708,168202
435,279.30435425423786,255,0.01262727532529747,16.31307217180729,168457
436,42.335736255228454,146,0.012501002572044496,14.817549893856048,168603
437,237.10660842547716,235,0.01237599254632405,9.52959370970726,168838
438,-223.12602972766206,138,0.01225223262086081,8.58885624885559,168976
439,192.43086954740573,233,0.012129710294652202,12.135124506950378,169209
440,250.1764685670095,464,0.01200841319170568,8.724285862445832,169673
441,250.93399276972104,252,0.011888329059788623,8.605378120541573,169925
442,134.20401173887478,281,0.011769445769190737,12.89458785891533,170206
443,239.65609072444798,210,0.01165175131149883,13.835798476934434,170416
444,246.73884294792737,275,0.011535233798383842,12.082018681764602,170691
445,243.71607987388373,284,0.011419881460400004,8.234223968982697,170975
446,239.60462348394924,284,0.011305682645796004,17.651808376312257,171259
447,280.3637137460279,167,0.011192625819338045,16.937737357616424,171426
448,199.94176551531035,288,0.011080699561144665,8.967904249429703,171714
449,232.64603941958023,341,0.010969892565533218,11.15637747824192,172055
450,282.621625264316,528,0.010860193639877886,9.144838858246803,172583
451,236.64764915593304,255,0.010751591703479106,19.400405663251878,172838
452,260.2936244427805,338,0.010644075786444315,21.364521349668504,173176
453,233.1363586575091,238,0.010537635028579873,14.370857365131378,173414
454,199.17543681459685,605,0.010432258678294073,12.608981122374535,174019
455,226.99395445883243,233,0.010327936091511133,10.469458028674126,174252
456,197.4037558675767,290,0.010224656730596022,7.5299637490510944,174542
457,6.389699869830608,150,0.01012241016329006,39.71932193517685,174692
458,187.18035214086805,450,0.01002118606165716,29.778498562574388,175142
459,281.1867283592922,611,0.009920974201040588,7.218984562158584,175753
460,247.98459867686668,250,0.009920974201040588,14.248286889791489,176003
461,295.4463559279683,242,0.009920974201040588,13.000711748600006,176245
462,251.92025861920328,203,0.009920974201040588,10.312759976387024,176448
463,238.71815780187364,214,0.009920974201040588,34.578647795319554,176662
464,287.5645718915084,251,0.009920974201040588,20.979237706065177,176913
465,269.6491181620702,355,0.009920974201040588,10.56621032357216,177268
466,248.57046739139946,232,0.009920974201040588,14.763877633213998,177500
467,225.95284476172571,335,0.009920974201040588,11.678778787851334,177835
468,289.094188021127,470,0.009920974201040588,12.492810699939728,178305
469,250.72065350497996,250,0.009920974201040588,12.89787297487259,178555
470,242.40067895117983,215,0.009920974201040588,15.966070241332055,178770
471,310.7811886598746,410,0.009920974201040588,6.676769033074379,179180
472,268.76801957435396,212,0.009920974201040588,7.480949508547783,179392
473,244.91538861080997,540,0.009920974201040588,10.7282190823555,179932
474,275.16501769360957,230,0.009920974201040588,10.62190592288971,180162
475,184.79195390223356,345,0.009920974201040588,6.40891437292099,180507
476,55.966394691143506,143,0.009920974201040588,13.669873453378678,180650
477,261.07742979770063,813,0.009920974201040588,18.25527612566948,181463
478,229.53466319733843,403,0.009920974201040588,7.125435643792152,181866
479,29.88807914221084,224,0.009920974201040588,10.801967299580575,182090
480,307.0718317869783,239,0.009920974201040588,12.903677435517311,182329
481,220.43489924720228,387,0.009920974201040588,10.096659898161889,182716
482,269.69256023523906,289,0.009920974201040588,7.714604886174202,183005
483,245.54390396732097,302,0.009920974201040588,6.722048959136009,183307
484,253.299917929042,250,0.009920974201040588,13.105252451896668,183557
485,231.67054445117503,326,0.009920974201040588,7.275689686536789,183883
486,250.03370918938626,257,0.009920974201040588,11.69134899199009,184140
487,245.8491082945046,287,0.009920974201040588,12.915382241606713,184427
488,281.75725595550455,204,0.009920974201040588,10.011850937008857,184631
489,274.9898721143028,213,0.009920974201040588,19.045823472738267,184844
490,257.23396247132484,214,0.009920974201040588,14.41435082435608,185058
491,223.71614707336227,371,0.009920974201040588,5.6744380098581315,185429
492,265.2875290408365,326,0.009920974201040588,5.030526017546654,185755
493,251.3188848008038,268,0.009920974201040588,27.570339673161506,186023
494,-228.25035566477467,90,0.009920974201040588,29.868056141138076,186113
495,276.7639702329545,170,0.009920974201040588,4.963424395918846,186283
496,273.75252800576897,192,0.009920974201040588,11.810733158886432,186475
497,-6.807565751765722,92,0.009920974201040588,11.6557847738266,186567
498,259.19757472047684,189,0.009920974201040588,10.536020543575287,186756
499,259.75096976703924,270,0.009920974201040588,19.06472588121891,187026
500,234.78311291299102,194,0.009920974201040588,10.84828192949295,187220
501,289.0493804643962,347,0.009920974201040588,13.456718294620513,187567
502,145.06301745096027,1000,0.009920974201040588,5.669751032590866,188567
503,269.4186993220342,301,0.009920974201040588,7.469584876894951,188868
504,275.98356540504165,268,0.009920974201040588,11.31326570212841,189136
505,275.91266979136617,226,0.009920974201040588,6.641393532752991,189362
506,266.9284471692988,211,0.009920974201040588,5.363736999630928,189573
507,249.38680293571332,217,0.009920974201040588,4.60143793284893,189790
508,273.2015764233081,274,0.009920974201040588,11.569449567198753,190064
509,-11.639602280551287,151,0.009920974201040588,4.910060898065567,190215
510,32.977168648191935,140,0.009920974201040588,5.173902782797813,190355
511,259.3614302010427,179,0.009920974201040588,5.42634073138237,190534
512,264.77571906447577,198,0.009920974201040588,19.838201217651367,190732
513,48.685398404987126,167,0.009920974201040588,11.588155134916306,190899
514,247.31047942775112,277,0.009920974201040588,18.05035295903683,191176
515,274.5760002388347,182,0.009920974201040588,17.002626668810844,191358
516,25.135918396356956,117,0.009920974201040588,6.346378889679909,191475
517,30.252383706716444,171,0.009920974201040588,8.272593756318093,191646
518,275.983155098128,204,0.009920974201040588,9.286780132055283,191850
519,267.2454898633606,196,0.009920974201040588,10.09892680823803,192046
520,247.24284958854847,166,0.009920974201040588,13.493179580569267,192212
521,241.6649592883159,234,0.009920974201040588,9.9104042750597,192446
522,220.75441637476774,325,0.009920974201040588,9.129950506091118,192771
523,259.956285657938,260,0.009920974201040588,7.099021822810173,193031
524,-9.837713885776324,126,0.009920974201040588,9.390310289263725,193157
525,264.89527068419693,196,0.009920974201040588,7.804420017004013,193353
526,281.37374575457517,186,0.009920974201040588,19.19094648063183,193539
527,259.1683831295726,209,0.009920974201040588,12.06637674510479,193748
528,41.61356348475539,133,0.009920974201040588,7.002047574520111,193881
529,291.15545620300577,213,0.009920974201040588,20.669137427210806,194094
530,262.41566183211296,156,0.009920974201040588,14.498243387937546,194250
531,243.66381015952675,353,0.009920974201040588,10.01567296564579,194603
532,283.80636055530067,297,0.009920974201040588,11.379472363591194,194900
533,239.19136572458308,267,0.009920974201040588,18.13994749724865,195167
534,7.466468775620513,146,0.009920974201040588,11.676733415126801,195313
535,275.17830397600727,272,0.009920974201040588,8.865690274834632,195585
536,245.14420768890446,246,0.009920974201040588,25.971198530197142,195831
537,264.7123229063031,365,0.009920974201040588,12.0708362865448,196196
538,243.4065159514158,296,0.009920974201040588,11.33233812212944,196492
539,242.2803206535664,259,0.009920974201040588,16.4852803504467,196751
540,232.69243868798335,329,0.009920974201040588,10.915835990309715,197080
541,289.93865495598345,219,0.009920974201040588,6.281072035431862,197299
542,240.0901896120724,314,0.009920974201040588,10.108836632370949,197613
543,284.1776955662333,235,0.009920974201040588,10.048202415108682,197848
544,253.35465480688157,309,0.009920974201040588,8.760162664055825,198157
545,220.77095449942607,521,0.009920974201040588,15.670795076489448,198678
546,-13.10469340596012,143,0.009920974201040588,13.94559513926506,198821
547,253.66384919587452,394,0.009920974201040588,9.738885639905929,199215
548,254.24833550876107,343,0.009920974201040588,11.702330014109611,199558
549,-6.624466371405816,112,0.009920974201040588,14.617209030985832,199670
550,243.6122610148246,343,0.009920974201040588,14.720990795493126,200013
