episode,reward,length,epsilon,mean_loss,steps
1,-335.7483172191098,118,0.995,4.3621181028860585,118
2,-329.5083132265162,95,0.990025,57.55419634521007,213
3,-316.89856447991053,111,0.985074875,67.88326296567917,324
4,-90.43723956745984,85,0.9801495006250001,68.2432584142685,409
5,-109.84023045043618,83,0.9752487531218751,62.61691691160202,492
6,-67.71836955717131,69,0.9703725093562657,83.45256479978562,561
7,-138.79297588358224,98,0.9655206468094844,89.55109995365143,659
8,-131.6983862371046,86,0.960693043575437,86.69714908123017,745
9,-100.30388378853439,90,0.9558895783575597,44.76506798386574,835
10,-265.72913752015705,64,0.9511101304657719,37.431371184587476,899
11,-135.84667639433803,70,0.946354579813443,38.867611031532284,969
12,-193.9334014543001,118,0.9416228069143757,29.355680344104766,1087
13,-66.07936340375855,67,0.9369146928798039,37.064099671840665,1154
14,-55.33245073648125,95,0.9322301194154049,56.80697298526764,1249
15,-356.5415602451818,87,0.9275689688183278,59.47673810005188,1336
16,-88.9884360692344,62,0.9229311239742362,54.963379278182984,1398
17,-178.37345449922785,96,0.918316468354365,41.57176162719727,1494
18,-69.68209426784779,65,0.9137248860125932,39.84415573120117,1559
19,-122.435194149461,79,0.9091562615825302,45.42062204837799,1638
20,-173.58111123715656,73,0.9046104802746175,46.581117992401126,1711
21,-117.80290234158673,62,0.9000874278732445,37.21101597547531,1773
22,-177.9038199757402,76,0.8955869907338783,32.085547304153444,1849
23,-72.68480283770123,107,0.8911090557802088,38.6030091047287,1956
24,-97.36469045158377,71,0.8866535105013078,37.33188873052597,2027
25,-72.35234070568066,118,0.8822202429488013,26.664743499755858,2145
26,-156.05626435011712,63,0.8778091417340573,29.009862327575682,2208
27,4.814148579521316,80,0.8734200960253871,25.948094403743745,2288
28,-100.57396759758308,102,0.8690529955452602,41.31438755512237,2390
29,-121.62432268215056,78,0.8647077305675338,25.120997643470766,2468
30,-103.45827709805891,85,0.8603841919146962,21.864490494728088,2553
31,-94.07430395849059,107,0.8560822709551227,26.508283643722535,2660
32,-162.12808536581844,97,0.851801859600347,22.21296555519104,2757
33,-83.63849195465842,64,0.8475428503023453,27.305421497821808,2821
34,-118.7720548826125,117,0.8433051360508336,24.79808952331543,2938
35,-111.9873531881583,110,0.8390886103705794,29.56941998243332,3048
36,-88.13529367506477,67,0.8348931673187264,26.773657760620118,3115
37,-121.66863875097046,102,0.8307187014821328,20.5859361243248,3217
38,-140.91022835941953,87,0.8265651079747222,31.0415704202652,3304
39,-105.22219315770658,85,0.8224322824348486,26.907198078632355,3389
40,-101.1257484599326,75,0.8183201210226743,30.437107772827147,3464
41,-133.95561832910914,148,0.8142285204175609,34.39600910663605,3612
42,-136.50134336911918,94,0.810157377815473,30.65305901885033,3706
43,-58.617328807694065,65,0.8061065909263957,33.46233794808388,3771
44,-98.6485994092696,80,0.8020760579717637,30.563963384628295,3851
45,-77.81510170512159,67,0.798065677681905,30.18329878807068,3918
46,-176.78781882838047,123,0.7940753492934954,27.61484352350235,4041
47,-396.5586770996045,138,0.7901049725470279,29.939984164237977,4179
48,-147.55146798912875,98,0.7861544476842928,34.62360159397125,4277
49,-125.20349738835733,91,0.7822236754458713,28.44982735157013,4368
50,-52.45948562129826,60,0.778312557068642,26.42200340986252,4428
51,-41.08740841558678,114,0.7744209942832988,23.473503994941712,4542
52,-74.21816179000972,90,0.7705488893118823,24.563471417427063,4632
53,-48.78285315015584,68,0.7666961448653229,22.80262326478958,4700
54,-60.91305145376897,110,0.7628626641409962,19.797013338804245,4810
55,-83.19746692732538,66,0.7590483508202912,23.282829644680024,4876
56,-103.69745359294677,96,0.7552531090661897,22.383675470352173,4972
57,-99.66356249633537,122,0.7514768435208588,24.667470252513887,5094
58,-99.61132415911113,106,0.7477194593032545,22.77976177453995,5200
59,-70.48630866389944,64,0.7439808620067382,26.894961709976197,5264
60,-88.49710993637153,122,0.7402609576967045,37.17737271308899,5386
61,-88.65025573989084,104,0.736559652908221,28.221882100105287,5490
62,-165.30972198267102,75,0.7328768546436799,20.24770827770233,5565
63,-71.77372623267308,95,0.7292124703704616,16.053882472515106,5660
64,-148.9463727724847,88,0.7255664080186093,19.034449288845064,5748
65,-91.20650556677417,102,0.7219385759785162,28.790216126441955,5850
66,-76.00456968782089,81,0.7183288830986236,31.66821563720703,5931
67,-87.45022726745876,87,0.7147372386831305,22.286894612312317,6018
68,-39.84943415443473,126,0.7111635524897149,19.109716367721557,6144
69,-139.9818501916027,109,0.7076077347272662,14.673748326301574,6253
70,-75.45412196571368,82,0.7040696960536299,18.27660455465317,6335
71,-54.38176105942746,107,0.7005493475733617,18.199216755628587,6442
72,-73.20437639441137,115,0.697046600835495,16.83796669960022,6557
73,-105.79428699060685,103,0.6935613678313175,31.531065897941588,6660
74,-75.9312324285564,63,0.6900935609921609,33.822422399520875,6723
75,-73.19829562857632,97,0.6866430931872001,27.94043771505356,6820
76,-118.55630397885339,119,0.6832098777212641,22.97193810939789,6939
77,-71.2163752006437,75,0.6797938283326578,20.132327551841737,7014
78,-119.67598024194784,122,0.6763948591909945,13.022773191928863,7136
79,-68.53868834348047,90,0.6730128848950395,18.09363548517227,7226
80,-23.26988369805528,124,0.6696478204705644,16.88380560874939,7350
81,-64.99314543221055,95,0.6662995813682115,16.3508341550827,7445
82,-2.358992233414824,137,0.6629680834613705,20.555464589595793,7582
83,-77.38524590327367,67,0.6596532430440636,20.323297245502474,7649
84,-131.1301625363255,77,0.6563549768288433,19.167277562618256,7726
85,-52.83630547897674,124,0.653073201944699,20.976611528396607,7850
86,-83.8074375811616,84,0.6498078359349755,20.63943891763687,7934
87,5.988931985909659,89,0.6465587967553006,20.676833279132843,8023
88,-64.31633968336557,82,0.6433260027715241,31.066956012248994,8105
89,-181.39191415177584,112,0.6401093727576664,23.475313222408296,8217
90,-124.28911689640577,119,0.6369088258938781,36.767535495758054,8336
91,-91.96216348281989,77,0.6337242817644086,43.72006350517273,8413
92,-460.3910494309091,126,0.6305556603555866,33.91432102203369,8539
93,-86.41955593090515,122,0.6274028820538087,22.68238184928894,8661
94,-38.783513418093435,154,0.6242658676435396,26.729509706497193,8815
95,-396.90659875950365,105,0.6211445383053219,29.724061422348022,8920
96,-20.066157196412234,88,0.6180388156137953,30.092751967906953,9008
97,-49.15574348495541,88,0.6149486215357263,22.67708539009094,9096
98,-295.8308614630778,79,0.6118738784280476,27.654606218338014,9175
99,-52.874924181065964,131,0.6088145090359074,32.58554329872131,9306
100,-85.38149575437116,143,0.6057704364907278,26.386606817245482,9449
101,-348.9996833305909,75,0.6027415843082742,26.124869837760926,9524
102,-197.05156249313396,57,0.5997278763867329,27.980805945396423,9581
103,-55.702156694572885,101,0.5967292370047992,31.60567913770676,9682
104,-57.9996376714128,75,0.5937455908197752,24.953376955986023,9757
105,-59.317232568688055,66,0.5907768628656763,31.530642240047456,9823
106,-239.80140739492597,60,0.5878229785513479,38.73075943470001,9883
107,-46.42127050313894,78,0.5848838636585911,38.622484998703,9961
108,-86.30206730738252,105,0.5819594443402982,41.9916756439209,10066
109,-73.31998396602877,63,0.5790496471185967,66.32584769248962,10129
110,-182.2891889139217,107,0.5761543988830038,47.38053078174591,10236
111,-273.0429983242294,103,0.5732736268885887,46.58441009998322,10339
112,-206.36106423371322,69,0.5704072587541458,36.032850601673125,10408
113,-312.61574592346346,129,0.567555222460375,37.225139105319975,10537
114,-140.30018900394725,71,0.5647174463480732,43.79017407894135,10608
115,-228.34323907677316,142,0.5618938591163328,45.04135517120361,10750
116,-50.02888865681959,156,0.5590843898207511,41.36581995010376,10906
117,-227.22296586133757,437,0.5562889678716474,51.51258363246918,11343
118,-92.73724266288187,155,0.5535075230322891,37.5959225320816,11498
119,7.769504055978217,95,0.5507399854171277,32.15825141906738,11593
120,-76.1904862332006,80,0.547986285490042,35.33670464515686,11673
121,-22.425430935866487,107,0.5452463540625918,31.98653788328171,11780
122,-72.82674034924918,63,0.5425201222922789,24.058911786079406,11843
123,-157.66210324895582,90,0.5398075216808175,25.063732101917267,11933
124,-24.114312413473655,126,0.5371084840724134,28.827817811965943,12059
125,-157.03697705961272,66,0.5344229416520513,28.473130860328673,12125
126,-44.90840253780281,92,0.531750826943791,27.578283846378326,12217
127,-101.00958401394885,177,0.5290920728090721,22.280051844120024,12394
128,-255.28155465820416,126,0.5264466124450268,33.09790442228317,12520
129,-41.31855438383731,131,0.5238143793828016,25.852498517036437,12651
130,-73.40199296367452,156,0.5211953074858876,18.911675300598144,12807
131,-146.81225311074985,155,0.5185893309484582,29.32554563999176,12962
132,-181.60097192615945,124,0.5159963842937159,40.39904148101807,13086
133,-130.4114735215786,113,0.5134164023722473,26.577512278556824,13199
134,-162.35195283282513,91,0.510849320360386,21.789281582832338,13290
135,-80.29580160131906,124,0.5082950737585841,28.65348857164383,13414
136,-130.89520535968154,99,0.5057535983897912,28.487330284118652,13513
137,-154.5775569443627,130,0.5032248303978422,29.82131301879883,13643
138,-169.8975777401057,99,0.500708706245853,24.991062474250793,13742
139,42.13420546648459,118,0.4982051627146237,16.430514481067657,13860
140,-56.216477058830236,143,0.49571413690105054,28.02486648082733,14003
141,-46.878091823741585,150,0.4932355662165453,21.639843542575836,14153
142,-36.28956838333099,194,0.4907693883854626,18.51842384338379,14347
143,-10.757470912742122,120,0.4883155414435353,23.934747714996337,14467
144,-28.21749824360228,171,0.4858739637363176,23.089241244792937,14638
145,-89.89095780604897,156,0.483444593917636,44.996442694664005,14794
146,-24.75644941855795,150,0.4810273709480478,30.78506730079651,14944
147,-355.55351323723653,395,0.47862223409330756,29.170596075057983,15339
148,-12.968420055132086,222,0.47622912292284103,30.811951785087587,15561
149,-63.20675492982721,100,0.4738479773082268,40.30404892444611,15661
150,-187.77778096825278,188,0.47147873742168567,39.18265809774399,15849
151,-248.47348199823205,213,0.46912134373457726,33.48239225149155,16062
152,-134.3386998945379,357,0.46677573701590436,30.514523062705994,16419
153,-202.7788514898238,265,0.46444185833082485,34.74727817296982,16684
154,-134.92296513523635,349,0.46211964903917074,19.79262156009674,17033
155,-24.03197826200224,165,0.4598090507939749,22.950021002292633,17198
156,-40.446107935576705,177,0.457510005540005,32.950094723701476,17375
157,-74.13424430269482,153,0.45522245551230495,34.93837212562561,17528
158,-327.20681890383804,276,0.4529463432347434,22.75985023021698,17804
159,-211.12057904398046,410,0.4506816115185697,30.430924191474915,18214
160,-17.758637549181927,373,0.4484282034609769,23.468208951950075,18587
161,-98.30540277549983,340,0.446186062443672,21.25604119300842,18927
162,-49.79014496176228,617,0.4439551321314536,33.230454335212706,19544
163,-75.0560766103417,431,0.4417353564707963,35.244995958805085,19975
164,-83.7804132610914,358,0.43952667968844233,40.411771879196166,20333
165,21.94516296183386,285,0.43732904629000013,51.686572728157046,20618
166,-103.55110798227693,572,0.4351424010585501,50.139673986434936,21190
167,-68.52847770953889,132,0.43296668905325736,43.97541654348373,21322
168,-77.52850225391232,132,0.43080185560799106,35.03124292373657,21454
169,-70.9904091262087,1000,0.4286478463299511,31.842395272254944,22454
170,-214.1810801972752,547,0.42650460709830135,27.66292482852936,23001
171,-56.17779896612322,129,0.42437208406280985,31.988576679229737,23130
172,-23.17045219191533,109,0.4222502236424958,44.05691305160522,23239
173,-62.13232578437587,116,0.42013897252428334,40.46148100852966,23355
174,-201.16849479986644,213,0.4180382776616619,37.774115591049195,23568
175,-20.926691810814418,115,0.4159480862733536,42.79292634487152,23683
176,-31.979783949334248,146,0.41386834584198684,43.35836407661438,23829
177,-78.97161778492838,94,0.4117990041127769,47.033123965263364,23923
178,-310.1711116827162,943,0.40974000909221303,36.50948459625244,24866
179,-37.64970148740056,296,0.40769130904675194,51.77849678039551,25162
180,-140.05444553094108,307,0.40565285250151817,42.265015473365786,25469
181,-228.65971614628572,347,0.4036245882390106,31.74780061721802,25816
182,-15.142477576041792,1000,0.4016064652978155,40.81967346668243,26816
183,-10.085734261393682,115,0.3995984329713264,47.75885681629181,26931
184,-182.85967015508652,165,0.3976004408064698,41.78919421195984,27096
185,-35.49223873167844,194,0.39561243860243744,44.233214535713195,27290
186,-230.3204126213933,539,0.3936343764094253,50.10251880645752,27829
187,-301.62812291933653,446,0.39166620452737816,36.90937617778778,28275
188,-227.85396746198512,209,0.3897078735047413,71.99227409839631,28484
189,13.959733164826872,118,0.3877593341372176,51.2886345243454,28602
190,-72.13519249136336,132,0.3858205374665315,41.347320380210874,28734
191,-10.686019021021977,108,0.38389143477919885,61.270208806991576,28842
192,-91.51440551986285,101,0.3819719776053028,57.19474733829498,28943
193,-156.08223037019306,334,0.3800621177172763,47.32182231903076,29277
194,-45.2710778650292,93,0.37816180712868996,39.46389189243317,29370
195,33.45431330624271,124,0.37627099809304654,41.91261287212372,29494
196,27.93024241159497,1000,0.3743896431025813,63.344843816757205,30494
197,20.503899843487325,1000,0.37251769488706843,49.15722762107849,31494
198,-200.18096433786405,172,0.3706551064126331,55.695169868469236,31666
199,-20.24457330649569,1000,0.36880183088056995,56.04945202827454,32666
200,-144.6531681683728,529,0.3669578217261671,45.445467653274534,33195
201,9.620602976666092,133,0.36512303261753626,59.17667547225952,33328
202,-97.17576091973835,159,0.3632974174544486,44.40795952796936,33487
203,-3.2620486878292922,138,0.3614809303671764,47.64148077964783,33625
204,2.2274678385212496,144,0.3596735257153405,47.84285145282745,33769
205,77.4729198167145,1000,0.3578751580867638,72.49519557952881,34769
206,-7.8975095279978405,140,0.35608578229633,67.66117912769317,34909
207,-52.98328357390368,114,0.3543053533848483,75.35176034927368,35023
208,119.1503244831816,1000,0.35253382661792404,43.15371981620788,36023
209,-209.7417586481483,151,0.3507711574848344,53.89651830196381,36174
210,81.58056160610045,1000,0.34901730169741024,67.69144927978516,37174
211,15.458774163784511,185,0.3472722151889232,49.87635692596436,37359
212,82.510251510065,1000,0.3455358541129786,58.35521929264068,38359
213,97.85927643286784,1000,0.3438081748424137,49.64040693759918,39359
214,91.92762571475467,1000,0.3420891339682016,63.514357833862306,40359
215,-222.96628239400502,328,0.3403786882983606,47.80370377063751,40687
216,-35.90081093076233,107,0.3386767948568688,70.84665497779847,40794
217,-293.7155274912618,525,0.33698341088258443,49.414246273040774,41319
218,87.63306319553267,1000,0.3352984938281715,63.974639534950256,42319
219,85.36329689053206,1000,0.33362200135903064,126.67973956108094,43319
220,83.1471718032659,1000,0.33195389135223546,69.4395803117752,44319
221,-102.76027613480117,1000,0.3302941218954743,73.96150166034698,45319
222,91.4517414558365,1000,0.32864265128599696,89.6356817817688,46319
223,-73.00797793036756,137,0.326999438029567,88.46126460075378,46456
224,81.52086833375088,1000,0.3253644408394192,78.54225275039673,47456
225,50.7998180475176,1000,0.3237376186352221,109.40803555965424,48456
226,-9.269916767406116,172,0.322118930542046,95.46753922462463,48628
227,-30.511645728283284,132,0.32050833588933575,91.59387278556824,48760
228,-118.04108086381758,108,0.31890579420988907,66.83174282073975,48868
229,95.7269890046185,1000,0.3173112652388396,102.29062616348267,49868
230,-99.40432917767504,222,0.3157247089126454,90.414970703125,50090
231,-72.08255518059842,147,0.3141460853680822,90.48741718769074,50237
232,5.66089432524231,117,0.3125753549412418,96.6871122264862,50354
233,-11.37651397785531,127,0.31101247816653554,134.75826025009155,50481
234,-172.54053899678573,129,0.30945741577570285,110.22473226547241,50610
235,-349.46798871879014,123,0.3079101286968243,183.17958674430847,50733
236,-97.36735806918362,154,0.3063705780533402,137.05454058647155,50887
237,27.98952012862314,142,0.30483872516307353,135.46927819252014,51029
238,-304.2763143348533,322,0.3033145315372582,150.8560163116455,51351
239,-358.5900488419025,124,0.3017979588795719,73.29271715164185,51475
240,-15.562695675894119,345,0.30028896908517405,177.29352730751037,51820
241,-228.41717555663115,649,0.2987875242397482,95.76791433334351,52469
242,-421.32577344521945,484,0.29729358661854943,147.5883968448639,52953
243,-615.0186463680293,119,0.29580711868545667,207.40872547149658,53072
244,-240.84795839370335,203,0.2943280830920294,89.45602361679077,53275
245,-248.3757254383074,160,0.29285644267656924,89.27878576278687,53435
246,-341.10741404001857,438,0.2913921604631864,98.29654036521912,53873
247,-28.124613541943773,125,0.28993519966087045,109.47183602809906,53998
248,-339.6633736831316,428,0.2884855236625661,154.99042242050172,54426
249,-280.13823292099585,91,0.28704309604425327,149.26906160354613,54517
250,-362.9321380711676,119,0.285607880564032,126.49076979637147,54636
251,-167.18401883587956,104,0.28417984116121187,272.9507001543045,54740
252,-48.23314318085964,127,0.2827589419554058,96.99978737831115,54867
253,-178.79128584997443,181,0.28134514724562876,116.4382310295105,55048
254,-77.79627316601669,127,0.2799384215094006,100.56636963844299,55175
255,-266.0749833894539,116,0.27853872940185365,93.55868879795075,55291
256,-406.91495944697675,108,0.27714603575484437,78.04093421936035,55399
257,-71.92199803581688,111,0.2757603055760701,179.09973464012145,55510
258,-370.1806850857174,207,0.2743815040481898,158.02778242111205,55717
259,-93.62346732188875,136,0.2730095965279488,155.28465985298158,55853
260,-129.76013689438372,187,0.27164454854530906,107.80665115356446,56040
261,-313.4366439691597,194,0.2702863258025825,132.3628191947937,56234
262,-133.2692940018614,138,0.2689348941735696,208.45867259025573,56372
263,-15.185755672421054,1000,0.26759021970270175,154.1090507411957,57372
264,40.69426243588282,104,0.2662522686041882,120.53430833816529,57476
265,-157.36366850531357,245,0.2649210072611673,138.11878483772279,57721
266,-142.3817341641779,87,0.26359640222486147,134.78992897033692,57808
267,-112.58553239311537,96,0.26227842021373715,132.45887753486633,57904
268,-140.11599818917037,95,0.2609670281126685,150.30701771736145,57999
269,-88.73728036170357,191,0.25966219297210513,159.63509321212769,58190
270,-31.68793729154406,227,0.2583638820072446,150.5966653251648,58417
271,-238.02574418412294,268,0.2570720625972084,125.43724207878113,58685
272,-206.41010988330774,264,0.25578670228422234,136.8012574672699,58949
273,-123.21463179485075,86,0.25450776877280124,228.87054478645325,59035
274,-144.94676537297892,347,0.2532352299289372,135.63681389808656,59382
275,-126.187338360468,248,0.2519690537792925,135.57712854385375,59630
276,-137.1829219900844,263,0.2507092085103961,116.90491952896119,59893
277,-175.35602279311485,155,0.2494556624678441,95.102976436615,60048
278,-182.1187737794329,261,0.24820838415550486,78.19284040451049,60309
279,-315.6784784476223,186,0.24696734223472733,153.22029129981993,60495
280,66.1810655619115,1000,0.2457325055235537,165.92087957382202,61495
281,-46.7513311357093,106,0.24450384299593592,106.92314291000366,61601
282,-97.69771527604617,163,0.24328132378095624,194.96956315994262,61764
283,-171.84854267901898,753,0.24206491716205145,153.78767906188966,62517
284,42.18886700250937,125,0.2408545925762412,164.3065048599243,62642
285,159.18452500975818,561,0.23965031961336,141.0538570213318,63203
286,-91.75617475653242,147,0.2384520680152932,162.35063096046449,63350
287,-38.07928648498111,104,0.23725980767521673,157.73731594085694,63454
288,-206.3126606267836,199,0.23607350863684065,114.64830402374268,63653
289,123.6178981666368,901,0.23489314109365644,123.08190433025361,64554
290,-157.25575435107302,244,0.23371867538818816,145.68129238128662,64798
291,121.44417598039715,1000,0.23255008201124722,157.8380512714386,65798
292,-467.24419370786615,224,0.231387331601191,189.38265672683715,66022
293,-209.420319737106,204,0.23023039494318503,123.20386939048767,66226
294,-307.9123988640455,97,0.2290792429684691,159.38136813163757,66323
295,-346.56198217587166,106,0.22793384675362674,196.7643060684204,66429
296,-476.6059504197985,122,0.22679417751985861,138.37677375793456,66551
297,-191.94616897195453,179,0.22566020663225933,130.2467053794861,66730
298,-39.62623853025127,168,0.22453190559909803,325.38051599502563,66898
299,-224.2356815788119,57,0.22340924607110255,194.9407529067993,66955
300,-243.14066939762876,93,0.22229219984074702,203.43609716415406,67048
301,-295.2956322427333,96,0.2211807388415433,164.19062566757202,67144
302,-24.621128667635844,165,0.22007483514733558,126.95434383392335,67309
303,-194.82677690055095,64,0.2189744609715989,208.61932975769042,67373
304,-23.528842019150474,120,0.2178795886667409,196.51783430099488,67493
305,91.59206379375455,1000,0.2167901907234072,183.70197757720948,68493
306,-379.96113583738537,98,0.21570623976979014,118.57085569381714,68591
307,-113.21219878959151,68,0.21462770857094118,222.7202001953125,68659
308,-281.2311930074371,150,0.21355457002808648,179.78083959579467,68809
309,-493.59179007053604,108,0.21248679717794605,197.97970873832702,68917
310,111.13296740669907,1000,0.21142436319205632,140.64964044570922,69917
311,-8.853386919269056,258,0.21036724137609603,137.85203220367433,70175
312,9.529090418279353,97,0.20931540516921554,139.93950653076172,70272
313,-234.99474590254846,205,0.20826882814336947,145.03872045516968,70477
314,-323.9982476765962,139,0.20722748400265262,123.57335386276245,70616
315,-302.7964050098765,268,0.20619134658263935,97.78633323669433,70884
316,0.7822269748701274,157,0.20516038984972615,139.16956972122193,71041
317,-437.7651375533039,172,0.2041345879004775,113.11195890426636,71213
318,38.729202113615464,1000,0.2031139149609751,144.85034006118775,72213
319,-396.4823754898656,138,0.20209834538617025,141.4994906425476,72351
320,-248.9118100928236,311,0.2010878536592394,142.31567575454713,72662
321,-457.1474324175979,187,0.2000824143909432,115.32223918914795,72849
322,-442.5059766835011,524,0.19908200231898848,144.14264947891235,73373
323,-77.0228305067036,875,0.19808659230739353,167.07929730415344,74248
324,62.20087166245004,1000,0.19709615934585656,96.79300836563111,75248
325,49.80334691389843,1000,0.19611067854912728,137.0283103084564,76248
326,-32.10530441878055,129,0.19513012515638165,175.61907617568968,76377
327,-163.99269992378336,213,0.19415447453059972,128.04784587860107,76590
328,2.9109592761108685,1000,0.19318370215794672,162.5479650592804,77590
329,-227.42449141359833,202,0.192217783647157,83.89245018005371,77792
330,231.82208439420617,885,0.1912566947289212,91.06932990074158,78677
331,-34.27649804468163,163,0.1903004112552766,101.67968416213989,78840
332,-592.1517384447004,563,0.18934890919900021,118.43681547164917,79403
333,-167.50965030828849,488,0.18840216465300522,77.77083775520325,79891
334,82.3594498464838,1000,0.18746015382974018,77.25729696273804,80891
335,-134.54695501701087,533,0.1865228530605915,94.467595911026,81424
336,79.81676177361277,1000,0.18559023879528855,77.87903583526611,82424
337,158.04620140718393,386,0.1846622876013121,69.70168203353882,82810
338,176.59304387757822,552,0.18373897616330553,123.85237037658692,83362
339,172.0995232923724,677,0.182820281282489,75.02616950035095,84039
340,-115.89052183973347,304,0.18190617987607657,80.19036764144897,84343
341,-141.33821810961484,104,0.18099664897669618,83.63096240997315,84447
342,-68.29627676296276,696,0.1800916657318127,119.39117151260376,85143
343,-36.88049662483999,341,0.17919120740315364,134.1024087047577,85484
344,-23.824797167173145,195,0.17829525136613786,95.86924663543701,85679
345,194.4664765626682,767,0.17740377510930716,82.28181506156922,86446
346,229.03124500140206,744,0.17651675623376062,105.41747673034668,87190
347,-150.97896202894037,347,0.1756341724525918,65.70524997711182,87537
348,-168.64475730315755,519,0.17475600159032884,106.54410040855407,88056
349,-257.0701165298193,605,0.17388222158237718,81.26544826507569,88661
350,-316.03302358951885,668,0.1730128104744653,87.81613765716553,89329
351,-60.77332498177687,112,0.17214774642209296,82.47599343299866,89441
352,-85.27213881596643,1000,0.1712870076899825,81.81692338943482,90441
353,-68.26730583738586,94,0.17043057265153258,67.20138936042785,90535
354,-5.642007318503735,1000,0.16957841978827493,74.62047280311585,91535
355,-448.3420730251431,309,0.16873052768933355,75.52622884750366,91844
356,-250.9013765457224,328,0.1678868750508869,82.67229806900025,92172
357,-90.03183334069595,98,0.16704744067563246,55.616440048217775,92270
358,41.293362212319806,275,0.1662122034722543,134.42505148887633,92545
359,-90.241832959683,65,0.16538114245489302,147.61935521125793,92610
360,-87.21887235003202,538,0.16455423674261854,92.78868982315063,93148
361,14.765085630364869,1000,0.16373146555890544,61.76459681510925,94148
362,69.87756473325457,1000,0.16291280823111093,66.34734923362731,95148
363,-32.68507141870272,81,0.16209824418995536,50.201179037094114,95229
364,-301.4226142470689,122,0.16128775296900558,67.69323948860169,95351
365,-156.05948994407686,567,0.16048131420416054,79.75370497703553,95918
366,-93.1414479642502,365,0.15967890763313974,62.613353157043456,96283
367,-247.16581188022238,598,0.15888051309497406,76.83196626663208,96881
368,9.60478635958016,1000,0.1580861105294992,57.139811735153195,97881
369,-73.77589170764304,1000,0.1572956799768517,60.863686141967776,98881
370,63.711564585554065,1000,0.15650920157696743,52.726437058448795,99881
371,-124.37174703137956,592,0.1557266555690826,56.65082023620605,100473
372,60.03082328050519,1000,0.1549480222912372,50.151003761291506,101473
373,196.3949587951407,565,0.15417328217978102,36.832235202789306,102038
374,50.09370099049215,1000,0.1534024157688821,42.63152815818787,103038
375,-48.96871182411286,110,0.1526354036900377,49.763021059036255,103148
376,248.16508931192874,887,0.1518722266715875,72.21472694396972,104035
377,201.74973662826386,891,0.15111286553822956,51.19667971611023,104926
378,122.65954097781132,900,0.15035730121053842,48.83957326889038,105826
379,19.109671921146912,184,0.14960551470448571,51.285869369506834,106010
380,86.29386799760536,1000,0.14885748713096328,70.28521275043488,107010
381,-169.8801899978701,391,0.14811319969530845,59.72749141693115,107401
382,-10.795921850958507,1000,0.1473726336968319,32.55810523033142,108401
383,-132.53237359513918,167,0.14663577052834775,35.39679186820984,108568
384,-341.2109756335483,248,0.14590259167570602,40.488252663612364,108816
385,-241.81581244687294,142,0.1451730787173275,41.08753814220429,108958
386,-222.75562524013623,102,0.14444721332374086,57.39022815704346,109060
387,-323.40618464896323,171,0.14372497725712216,50.75517074584961,109231
388,-234.82190430969428,155,0.14300635237083656,42.19610960006714,109386
389,132.73559008388864,1000,0.14229132060898236,75.35298731803894,110386
390,-5.722341573442037,254,0.14157986400593744,36.34526576042175,110640
391,-84.57711235236198,99,0.14087196468590776,50.096622853279115,110739
392,-53.706886625661525,118,0.14016760486247823,48.91594834327698,110857
393,231.46882905241233,963,0.13946676683816583,39.15011863708496,111820
394,-231.59926161997757,208,0.138769433003975,43.49650497436524,112028
395,-177.69023025209282,198,0.13807558583895513,39.56271888256073,112226
396,303.0790453489566,376,0.13738520790976036,39.13692152023315,112602
397,-222.45966629918337,181,0.13669828187021155,34.48810719966888,112783
398,-254.88405452039876,292,0.13601479046086049,41.45562448978424,113075
399,-115.67088872828917,308,0.1353347165085562,36.369177069664005,113383
400,198.28674980978434,837,0.1346580429260134,34.37613701343536,114220
401,6.371424392777399,126,0.13398475271138335,43.31646147727966,114346
402,-79.8792610092174,551,0.13331482894782642,36.03875674247742,114897
403,-16.71919721901777,1000,0.13264825480308728,35.447440452575684,115897
404,-201.266084906981,248,0.13198501352907185,79.43838099479676,116145
405,34.2489495909172,1000,0.1313250884614265,63.18206076622009,117145
406,-195.21331691180217,111,0.13066846301911936,65.47000424385071,117256
407,-194.52299121681074,684,0.13001512070402377,41.943883743286136,117940
408,-157.47172820896458,1000,0.12936504510050365,50.880536103248595,118940
409,-123.05739221752589,230,0.12871821987500112,38.27947400093078,119170
410,-66.81342055585262,1000,0.12807462877562611,40.08181914329529,120170
411,-27.27011990458876,1000,0.12743425563174798,48.30850552558899,121170
412,-242.72572282829339,599,0.12679708435358925,35.920217328071594,121769
413,-540.0681049850721,114,0.1261630989318213,28.744050574302673,121883
414,-183.2265808496196,86,0.1255322834371622,45.27691802024842,121969
415,-307.74353350496244,158,0.12490462201997637,40.0803710269928,122127
416,-289.95307147133565,116,0.1242800989098765,56.067199583053586,122243
417,-353.9991238540233,250,0.12365869841532712,44.94276267051697,122493
418,-248.30153795479677,107,0.12304040492325048,34.255023188591004,122600
419,-196.3879365881176,138,0.12242520289863423,41.19045321464539,122738
420,-167.63099255021973,97,0.12181307688414106,43.19517119884491,122835
421,-204.38389287646757,127,0.12120401149972035,50.121388440132144,122962
422,-195.10490976731288,200,0.12059799144222175,61.3217223072052,123162
423,-118.93942715556688,497,0.11999500148501063,51.87357545852661,123659
424,-126.32619916105448,132,0.11939502647758558,62.071117095947265,123791
425,55.76584505197257,1000,0.11879805134519765,33.07857532978058,124791
426,-140.33945745786355,151,0.11820406108847166,38.29738844871521,124942
427,-0.6170282512205745,275,0.1176130407830293,48.437731428146364,125217
428,-83.22104825515606,306,0.11702497557911415,50.94281037807465,125523
429,-147.40208879824755,413,0.11643985070121858,98.56000270843506,125936
430,-165.79790639011955,550,0.11585765144771248,45.595340461730956,126486
431,-159.84158848136917,412,0.11527836319047392,42.04508425712586,126898
432,-329.6906453522066,399,0.11470197137452155,88.53620568275451,127297
433,-274.0393993383599,438,0.11412846151764894,59.543859300613406,127735
434,-521.6712568940866,93,0.1135578192100607,57.39468601226807,127828
435,-150.96977839840963,232,0.11299003011401039,60.81406833648682,128060
436,-200.19304742626076,164,0.11242507996344034,72.21832065582275,128224
437,-164.2888384361517,346,0.11186295456362313,57.05678623199463,128570
438,-112.95742868657251,100,0.11130363979080501,51.325124711990355,128670
439,-232.4504214432705,87,0.11074712159185099,76.71153304100037,128757
440,-200.5276743974261,192,0.11019338598389174,66.53055895805359,128949
441,-314.20345772324447,195,0.10964241905397228,79.11902329444885,129144
442,-361.20887521477357,90,0.10909420695870241,83.87519792556763,129234
443,-95.73623722944558,128,0.1085487359239089,72.1145386505127,129362
444,-177.09701295754525,166,0.10800599224428936,64.56206386566163,129528
445,-84.03289184874292,181,0.10746596228306791,85.09074981689453,129709
446,-167.5827936941175,394,0.10692863247165257,78.3956053352356,130103
447,-780.6326467270657,530,0.1063939893092943,64.31531921386718,130633
448,-569.1598437042633,464,0.10586201936274783,130.71583332061766,131097
449,-1195.5515821736908,403,0.10533270926593409,107.03022125244141,131500
450,-704.8570947420677,251,0.10480604571960442,97.40911308288574,131751
451,-439.12007164065017,120,0.1042820154910064,89.45263360977172,131871
452,-80.4730602397734,206,0.10376060541355137,84.05578355789184,132077
453,-695.9527589239768,264,0.1032418023864836,69.81843835830688,132341
454,-1781.9188258816566,317,0.10272559337455119,253.21566665649414,132658
455,-223.23746957885322,276,0.10221196540767843,68.03842184066772,132934
456,-1161.108161305988,303,0.10170090558064004,195.98371770858765,133237
457,-527.1677540377623,158,0.10119240105273684,87.05562424659729,133395
458,-946.171409132891,177,0.10068643904747315,113.08548179626465,133572
459,-690.848400056972,163,0.10018300685223579,214.04287370681763,133735
460,-669.3789083705738,175,0.0996820918179746,245.56836349487304,133910
461,-248.40712921725148,95,0.09918368135888474,212.84365092277528,134005
462,-1687.467446158408,281,0.09868776295209031,1890.2171789550782,134286
463,-291.75762676719194,143,0.09819432413732986,383.82828899383543,134429
464,-2705.636479133141,329,0.09770335251664321,226.6720166015625,134758
465,-807.5448973029439,183,0.09721483575406,450.91015914916994,134941
466,-679.8363164510515,189,0.09672876157528969,537.5767476272583,135130
467,-659.9683445501786,264,0.09624511776741324,277.48969131469727,135394
468,-37.87001898453539,133,0.09576389217857617,270.6022337913513,135527
469,-1035.0584455335104,181,0.09528507271768329,1067.2374587249756,135708
470,-359.1089588026341,170,0.09480864735409487,407.0175299835205,135878
471,-374.76693429118933,92,0.0943346041173244,239.22684810638427,135970
472,-676.7753066270924,177,0.09386293109673778,134.47713573455812,136147
473,-2390.6269107294015,399,0.09339361644125409,226.58922832489014,136546
474,-647.4779585220908,145,0.09292664835904782,171.39185249328614,136691
475,-706.7578008741983,158,0.09246201511725258,659.8913828277588,136849
476,-1770.637859849603,343,0.09199970504166631,2854.7419205474853,137192
477,-358.07301576477795,102,0.09153970651645797,421.0033143615723,137294
478,-92.63632449216719,151,0.09108200798387568,1990.241178970337,137445
479,-2536.925663995678,364,0.0906265979439563,333.3118518066406,137809
480,-316.2482279550976,176,0.09017346495423652,2285.8738093566894,137985
481,-1033.0181831738469,121,0.08972259762946533,436.2580668258667,138106
482,-1631.836940981775,325,0.089273984641318,378.8534862136841,138431
483,-176.2205481013084,99,0.0888276147181114,265.64076175689695,138530
484,-294.8762054714209,207,0.08838347664452084,339.28614807128906,138737
485,-523.0884710956651,129,0.08794155926129824,286.9496021270752,138866
486,-3294.1016436911113,421,0.08750185146499175,268.32879814147947,139287
487,-847.6267807048029,472,0.08706434220766679,277.7422835922241,139759
488,-428.2813865069568,235,0.08662902049662846,320.4955737686157,139994
489,-1857.8165727288138,498,0.08619587539414532,573.2906404876709,140492
490,-1516.263051293427,440,0.08576489601717459,611.9329884719849,140932
491,-847.6240783362407,411,0.08533607153708872,1706.9550269317626,141343
492,-941.3262252371213,334,0.08490939117940327,1180.3885243225097,141677
493,-476.1780355720041,81,0.08448484422350626,1847.8487683105468,141758
494,-471.51115796135485,241,0.08406242000238873,1418.125885772705,141999
495,-1778.7634212457963,369,0.08364210790237678,2606.1473737335205,142368
496,-334.6725444246101,370,0.0832238973628649,1587.8432754898072,142738
497,-1171.5943721124947,393,0.08280777787605056,986.1843264770508,143131
498,-240.53499860623063,116,0.08239373898667031,1826.959425354004,143247
499,-1282.7439267019909,333,0.08198177029173696,1739.3169626998902,143580
500,-1635.8390404283616,379,0.08157186144027828,1034.571252975464,143959
501,-784.432277077576,307,0.0811640021330769,1690.6730410003663,144266
502,-1096.538582063335,198,0.08075818212241151,253.5539123916626,144464
503,-436.9509321004166,134,0.08035439121179945,484.62765892028807,144598
504,-792.8125015983563,142,0.07995261925574046,188.90876686096192,144740
505,-373.2750048068444,126,0.07955285615946175,1624.520010986328,144866
506,-334.14394539652716,173,0.07915509187866444,1647.7289980316161,145039
507,-365.19617475842847,96,0.07875931641927113,321.63071678161623,145135
508,-1030.6416285071298,196,0.07836551983717477,478.57208393096926,145331
509,-265.22412003500244,165,0.07797369223798889,1126.9981896209717,145496
510,-338.94320806139496,165,0.07758382377679894,359.01922996520995,145661
511,-584.7604067719662,172,0.07719590465791494,1010.8362029266358,145833
512,-642.4397847458948,200,0.07680992513462537,589.8765665435791,146033
513,-602.1762915919649,224,0.07642587550895225,330.1754737854004,146257
514,-800.116452749558,165,0.07604374613140748,342.0427747344971,146422
515,-469.0227795505711,221,0.07566352740075044,214.48995071411133,146643
516,-287.14292986569967,162,0.07528520976374668,364.9241515731812,146805
517,-463.3678120177714,213,0.07490878371492794,238.69396324157714,147018
518,-420.0352546076096,199,0.0745342397963533,1116.9758969879151,147217
519,-451.6039834885246,187,0.07416156859737154,271.6799523162842,147404
520,-311.9142570574222,1000,0.07379076075438468,388.72481094360353,148404
521,-213.9758114768,237,0.07342180695061275,339.1353865814209,148641
522,-337.85852606796095,253,0.07305469791585968,225.95630340576173,148894
523,-345.1046507943565,154,0.07268942442628039,337.56834159851076,149048
524,-357.99955581441714,163,0.07232597730414898,221.6568532562256,149211
525,-212.8502742366665,452,0.07196434741762824,443.58428565979005,149663
526,-546.3720409426915,210,0.0716045256805401,243.61604995727538,149873
527,-208.6157843369596,1000,0.0712465030521374,282.1536861419678,150873
528,-518.6835988849184,934,0.0708902705368767,296.16358810424805,151807
529,-1089.9163979484274,637,0.07053581918419231,381.96175994873045,152444
530,-1309.4327814741575,763,0.07018314008827135,297.35630043029784,153207
531,-531.0469934883656,341,0.06983222438783,270.30275497436526,153548
532,-1755.491883411771,677,0.06948306326589085,216.25283813476562,154225
533,-829.1641301310178,268,0.0691356479495614,195.35409805297851,154493
534,-219.7463455575679,341,0.06878996970981359,261.5560837173462,154834
535,-859.1605830021788,294,0.06844601986126451,193.83398166656494,155128
536,-583.6931893493438,367,0.06810378976195819,258.4697589111328,155495
537,-877.5231305964674,162,0.0677632708131484,183.19416915893555,155657
538,-793.791559514627,523,0.06742445445908266,176.52488174438477,156180
539,-780.4832977798015,390,0.06708733218678724,262.5679124832153,156570
540,-303.09855179498516,452,0.0667518955258533,286.79579200744627,157022
541,-378.3987904570645,407,0.06641813604822402,250.9163795852661,157429
542,-460.95757695870293,428,0.0660860453679829,272.2555825805664,157857
543,-637.2217459970112,296,0.06575561514114299,256.11454986572267,158153
544,-436.66187229596915,471,0.06542683706543727,339.88505447387695,158624
545,-671.035209423795,282,0.06509970288011008,240.97026557922362,158906
546,-705.7590072698362,332,0.06477420436570952,232.90340240478517,159238
547,-515.5503656416147,694,0.06445033334388098,121.69910224914551,159932
548,-193.80026917586284,1000,0.06412808167716157,122.10439270019532,160932
549,-225.80941107941658,1000,0.06380744126877576,219.07871068954466,161932
550,-269.9447574512025,789,0.06348840406243188,293.8503329086304,162721
551,-154.8390905127281,415,0.06317096204211972,277.14793880462645,163136
552,-307.5534200005668,53,0.06285510723190912,223.17746154785155,163189
553,-116.9088295109173,958,0.06254083169574957,87.42277976989746,164147
554,-317.41883764358664,79,0.062228127537270826,169.62463474273682,164226
555,-250.9951741321007,84,0.06191698689958447,175.82756465911865,164310
556,-390.4076281941198,108,0.061607401965086545,248.18944576263428,164418
557,-34.86937417105318,209,0.06129936495526111,150.46126918792726,164627
558,-38.71330322815308,248,0.0609928681304848,197.99838768005372,164875
559,44.495619531056406,248,0.060687903789832374,226.70548866271972,165123
560,-212.35986142451762,55,0.06038446427088321,193.61741706848144,165178
561,-135.39964854933748,61,0.06008254194952879,176.4163115310669,165239
562,-282.72425975143614,53,0.05978212923978115,337.62827934265135,165292
563,-440.1953091089123,811,0.05948321859358224,113.81190647125244,166103
564,-373.21399050153434,172,0.05918580250061433,286.9491843414307,166275
565,-187.08937336322208,205,0.058889873488111255,359.2804404830933,166480
566,-322.2521746401151,341,0.058595424120670696,254.35719303131103,166821
567,-407.5880847240504,346,0.05830244700006734,292.5807350540161,167167
568,-382.0098548739252,308,0.058010934765067,240.64220558166505,167475
569,-83.2947568750895,1000,0.05772088009124167,314.0411125946045,168475
570,-110.30962142329469,1000,0.05743227569078546,436.6227780914307,169475
571,-41.03357063088107,1000,0.05714511431233153,323.92754104614255,170475
572,-51.22495171445972,1000,0.05685938874076987,392.76380966186525,171475
573,-13.08884668527156,1000,0.056575091797066025,644.1709176635742,172475
574,-88.01298291280469,170,0.056292216338080694,578.4553117370606,172645
575,-133.13612813774145,136,0.05601075525639029,400.7806568908691,172781
576,-137.0868362974554,105,0.05573070148010834,605.8733279418946,172886
577,-57.136269200188636,385,0.0554520479727078,482.9248183441162,173271
578,-112.27411284879564,196,0.05517478773284426,542.1388410949708,173467
579,-65.16730553355733,437,0.05489891379418004,743.3857220458984,173904
580,-210.17695890915707,313,0.05462441922520914,484.589245223999,174217
581,-158.10839486224398,390,0.0543512971290831,317.5522808074951,174607
582,-113.19926856544913,263,0.05407954064343768,486.39248237609866,174870
583,-121.18328987626094,231,0.05380914294022049,405.0542261505127,175101
584,-336.5849360912076,655,0.05354009722551939,307.34700325012204,175756
585,-307.4355149791249,905,0.05327239673939179,387.3937050628662,176661
586,-129.40142388993104,172,0.053006034755694834,532.5421998596191,176833
587,-260.15103270969166,677,0.052741004581916356,591.7910528564453,177510
588,-111.09446173762043,144,0.052477299559006776,410.14117965698244,177654
589,-160.32693397530707,179,0.052214913061211746,295.79023231506346,177833
590,-226.59298763454575,377,0.05195383849590569,447.51202003479005,178210
591,-541.3830677251925,320,0.05169406930342616,313.78669921875,178530
592,-126.12392852917634,158,0.05143559895690903,510.28113204956054,178688
593,-181.22717144159446,423,0.051178420962124486,327.9154778289795,179111
594,-222.03855808576873,184,0.05092252885731386,320.834211730957,179295
595,-145.93673622196945,128,0.05066791621302729,359.9340660095215,179423
596,-201.36847552224268,366,0.05041457663196215,219.50016845703124,179789
597,-231.64352788350791,358,0.050162503748802344,293.8740203857422,180147
598,-232.6803893107945,126,0.049911691230058335,319.043299407959,180273
599,-166.33311383765928,127,0.04966213277390804,402.36137817382814,180400
600,-213.972822950987,153,0.0494138221100385,336.63931549072265,180553
601,-355.55176879007377,226,0.04916675299948831,301.3037745666504,180779
602,-110.4093814136545,152,0.04892091923449087,299.4258917999268,180931
603,-293.2141107991014,265,0.04867631463831842,373.2164266204834,181196
604,-205.08115498674476,158,0.048432933065126825,577.5613793182373,181354
605,-118.92090102398704,133,0.048190768399801194,407.3302128601074,181487
606,-192.94993851665157,182,0.04794981455780219,299.53654823303225,181669
607,-130.49504941357083,380,0.04771006548501318,447.7609907531738,182049
608,-226.1971100854251,305,0.047471515157588115,348.78519569396974,182354
609,-256.54017674152976,102,0.047234157581800176,245.25751091003417,182456
610,-247.46792130320677,469,0.046997986793891174,364.1190534210205,182925
611,-150.31887869017606,282,0.04676299685992172,426.43889358520505,183207
612,-222.83463092876625,409,0.04652918187562211,732.5123320007324,183616
613,-338.5206637197873,769,0.046296535966244,376.4694465637207,184385
614,-208.01105660040787,417,0.046065053286412784,362.53967712402346,184802
615,-132.04855855088425,155,0.04583472801998072,1104.928441772461,184957
616,-132.36648154201714,376,0.045605554379880814,854.6070593261719,185333
617,-108.55079791124679,697,0.04537752660798141,1465.9167680358887,186030
618,-162.1413305236631,161,0.0451506389749415,868.3693017578125,186191
619,-223.49075913011936,120,0.044924885780066794,507.6218292236328,186311
620,-224.44325625178882,206,0.04470026135116646,882.6844653320312,186517
621,-218.5342622118278,176,0.04447676004441063,1037.819913635254,186693
622,-244.45556471656323,182,0.04425437624418858,561.1765850830078,186875
623,-282.9709858573286,168,0.04403310436296763,541.2922515869141,187043
624,-153.0056963332401,233,0.043812938841152796,864.4132638549804,187276
625,-176.06631487232676,629,0.04359387414694703,540.8752365112305,187905
626,-180.35257125907708,1000,0.043375904776212296,1131.6426147460938,188905
627,-1872.875800032847,544,0.043159025252331236,543.2257942199707,189449
628,-2946.9254918222473,483,0.04294323012606958,416.1070425415039,189932
629,-2085.4750001552393,325,0.04272851397543923,626.2665095520019,190257
630,-505.52064774104076,103,0.04251487140556204,592.5052880859375,190360
631,-693.285098066207,183,0.04230229704853423,2267.714465942383,190543
632,-769.360485846585,145,0.04209078556329156,688.342459564209,190688
633,-909.8149476435797,242,0.0418803316354751,504.95357604980467,190930
634,-757.4217244357666,130,0.041670929977297724,1772.2100569152833,191060
635,-615.5705128269428,132,0.04146257532741124,1962.798980407715,191192
636,-738.0352647522063,207,0.04125526245077418,630.4332666015625,191399
637,-365.66231647740426,91,0.04104898613852031,701.1323191833496,191490
638,-432.26283683302006,94,0.04084374120782771,482.3157139587402,191584
639,-427.82676095029694,80,0.04063952250178857,583.3135060119629,191664
640,-502.64265669626974,99,0.04043632488927963,1016.3066171264649,191763
641,-670.7083864774122,140,0.04023414326483323,630.3025288391113,191903
642,-589.9043669528872,123,0.040032972548509065,709.7286227416993,192026
643,-680.3172762205573,161,0.03983280768576652,675.86974609375,192187
644,-500.63060841296397,114,0.03963364364733769,558.757825012207,192301
645,-664.7387749805904,230,0.039435475429100995,668.1143783569336,192531
646,-908.9049838192078,160,0.03923829805195549,726.5618475341797,192691
647,-603.2877224244216,167,0.03904210656169572,626.4765618896485,192858
648,-639.2139447192815,194,0.03884689602888724,520.5042420959472,193052
649,-491.8265647722022,119,0.0386526615487428,608.1374472045899,193171
650,-740.5781990043877,136,0.03845939824099909,508.75831069946287,193307
651,-419.21326952793254,159,0.03826710124979409,914.9870217895508,193466
652,-569.077285637477,172,0.038075765743545126,761.3787313842773,193638
653,-457.65147753960593,132,0.0378853869148274,835.7393615722656,193770
654,-536.8380844253876,168,0.03769595998025326,700.0903533935547,193938
655,-421.7802142469471,110,0.03750748018035199,742.8045645141601,194048
656,-408.3788810170852,102,0.037319942779450235,560.552998046875,194150
657,-515.0350103894493,130,0.037133343065552986,686.5667576599121,194280
658,-551.165472263425,151,0.03694767635022522,670.8994084167481,194431
659,-476.7814496378074,155,0.036762937968474095,779.2527206420898,194586
660,-603.5324022220927,133,0.03657912327863173,631.2381004333496,194719
661,-649.7423872397819,151,0.036396227662238566,783.3646362304687,194870
662,-537.0892103182673,125,0.03621424652392737,720.4048419189453,194995
663,-338.1138387883083,366,0.036033175291307735,701.1414859008789,195361
664,-430.4239983769496,110,0.03585300941485119,572.9731323242188,195471
665,-601.5634992366865,461,0.035673744367776934,799.1368601989747,195932
666,-482.43529856812205,153,0.03549537564593805,813.3602816772461,196085
667,-567.0736425067585,144,0.035317898767708356,660.4161753845215,196229
668,-398.97124650877413,191,0.03514130927386981,832.7370751953125,196420
669,-413.0194771396525,214,0.03496560272750046,982.4793334960938,196634
670,-360.9140663089212,129,0.03479077471386296,604.1774426269532,196763
671,-432.7496191499703,253,0.03461682084029365,878.9105352783204,197016
672,-607.956831568149,166,0.034443736736092176,779.1294448852539,197182
673,-375.0293672267124,240,0.034271518052411715,718.0390707397461,197422
674,-746.1929837523437,840,0.034100160462149656,852.7892169189453,198262
675,-272.8208953444189,1000,0.03392965965983891,748.7782557678223,199262
676,-677.3222613585558,665,0.033760011361539714,1298.0457885742187,199927
677,-750.8490096026914,618,0.03359121130473201,1243.9052087402345,200545
